# Hesudhar Corrections File
# Format: incorrect_word|corrected_word
# This file is automatically updated when the database changes
# Last updated: 2025-08-12
# Total entries: 9607

آئينه|آئينہ
آبگونه|آبگونہ
آبگينه|آبگينہ
آبله|آبلہ
آبوهڻ|آبوھڻ
آٻوهڻ|آٻوھڻ
آٻوهو|آٻوھو
آتاهه|آتاھ
آتشڪده|آتشڪدہ
آتلاه|آتلاھ
آتمڪيه|آتمڪيہ
آتڻاه|آتڻاھ
آجها|آجها
آجهاپ|آجهاپ
آجهاپو|آجهاپو
آجهار|آجهار
آجهارڻ|آجهارڻ
آجهانم|آجهانم
آجهرڻ|آجهرڻ
آجهڙڪڻ|آجهڙڪڻ
آجهڙڻآجهڙڻ|آجهڙڻآجهڙڻ
آجهڙيو|آجهڙيو
آجهڪڻ|آجهڪڻ
آجهه|آجهہ
آجهوڇڻ|آجهوڇڻ
آجهوڙو|آجهوڙو
آجهولو|آجهولو
آجهي|آجهي
آچاريه|آچاريہ
آداه|آداھ
آدينه|آدينہ
آذادانه|آذادانہ
آذرڪده|آذرڪدہ
آڌاه|آڌاھ
آڌهي|آڌھي
آڏواهر|آڏواھر
آراڙه|آراڙھ
آراڙهي|آراڙھي
آراسته|آراستہ
آراڪهه|آراڪھہ
آرنگهو|آرنگهو
آرنهن|آرنهن
آره|آرھ
آرهاڙ|آرھاڙ
آرهاڙي|آرھاڙي
آرهڙ|آرھڙ
آروجهيو|آروجهيو
آروگيه|آروگيہ
آروهڻ|آروھڻ
آروهه|آروھہ
آرويه|آرويہ
آريه|آريہ
آزادانه|آزادانہ
آزرده|آزردہ
آزقه|آزقہ
آزهر|آزھر
آزوقه|آزوقہ
آڙاه|آڙاھ
آڙاهه|آڙاهہ
آڙهاڙي|آڙھاڙي
آڙهنگ|آڙھنگ
آڙهه|آڙھہ
آسرنهن|آسرنھن
آسرنهه|آسرنھہ
آسمانه|آسمانہ
آسوده|آسودہ
آسيانه|آسيانہ
آسيه|آسيہ
آشفته|آشفتہ
آشڪاره|آشڪارہ
آصفيه|آصفيہ
آغشته|آغشتہ
آفتابه|آفتابہ
آفريقه|آفريقہ
آڦرلاهڻ|آڦرلاھڻ
آڪاهتو|آڪاھتو
آڪاهه|آڪاھ
آڪاهيو|آڪاھيو
آڪهه|آڪھہ
آگاه|آگاھ
آگاهه|آگاھ
آگاههآگاهي|آگاھآگاھي
آگاهي|آگاھي
آگره|آگرہ
آگهات|آگهات
آگهاتو|آگهاتو
آگهاٽجڻ|آگهاٽجڻ
آگهاٽو|آگهاٽو
آگهار|آگهار
آگهارائڻ|آگهارائڻ
آگهارجڻ|آگهارجڻ
آگهارڻ|آگهارڻ
آگهارو|آگهارو
آگهاڙو|آگهاڙو
آگهاگهمڻ|آگهاگهمڻ
آگهاڻو|آگهاڻو
آگهٽ|آگهٽ
آگهٽجڻ|آگهٽجڻ
آگهر|آگهر
آگهرائڻ|آگهرائڻ
آگهرجڻ|آگهرجڻ
آگهرڻ|آگهرڻ
آگهڙ|آگهڙ
آگهم|آگهم
آگهه|آگهہ
آگهور|آگهور
آگهوري|آگهوري
آگهي|آگهي
آگيه|آگيہ
آڳاجهه|آڳاجهه
آڳانجهوآڳانڌو|آڳانجهوآڳانڌو
آڳانهه|آڳانھہ
آڳاهه|آڳاھ
آڳاهون|آڳاھون
آڳاهي|آڳاھي
آڳاهين|آڳاھين
آڳهه|آڳھہ
آلنگهين|آلنگهين
آله|آلہ
آلهن|آلھن
آلوده|آلودہ
آلوماه|آلوماھ
آليه|آليہ
آماده|آمادہ
آماره|آمارہ
آماهڻ|آماھڻ
آمده|آمدہ
آمله|آملہ
آمنه|آمنہ
آمهائڻ|آمهائڻ
آمهون|آمهون
آموخته|آموختہ
آنبهه|آنبھہ
آنجهاني|آنجهاني
آنجهي|آنجهي
آنگاهو|آنگاھو
آنگها|آنگها
آنگهو|آنگهو
آنهان|آنھان
آنهر|آنھر
آنهرا|آنھرا
آنهري|آنھري
آنهڪار|آنھڪار
آنهڪارڻ|آنھڪارڻ
آنهل|آنھل
آنهن|آنھن
آنهه|آنھہ
آنهو|آنھو
آنهون|آنھون
آنهيرا|آنھيرا
آنهيري|آنھيري
آنوله|آنولہ
آها|آھا
آهار|آھار
آهاري|آھاري
آهان|آھان
آهت|آھت
آهتو|آھتو
آهتي|آھتي
آهٽ|آھٽ
آهر|آھر
آهرن|آھرن
آهرڻ|آھرڻ
آهرو|آھرو
آهري|آھري
آهريا|آھريا
آهرين|آھرين
آهڙ|آھڙ
آهڙڻ|آھڙڻ
آهڙو|آھڙو
آهستگي|آھستگي
آهسته|آھستہ
آهستو|آھستو
آهستي|آھستي
آهڪ|آھڪ
آهڳ|آھڳ
آهل|آھل
آهلائڻ|آھلائڻ
آهلجڻ|آھلجڻ
آهلڻ|آھلڻ
آهليل|آھليل
آهم|آھم
آهن|آھن
آهنڊ|آھنڊ
آهنر|آھنر
آهنگ|آھنگ
آهنگر|آھنگر
آهني|آھني
آهڻو|آھڻو
آهه|آھہ
آهو|آھو
آهوء|آھوء
آهوپا|آھوپا
آهوپرو|آھوپرو
آهوتي|آھوتي
آهوجا|آھوجا
آهوچشم|آھوچشم
آهورن|آھورن
آهورو|آھورو
آهوڙ|آھوڙ
آهوڙائڻ|آھوڙائڻ
آهوڙجڻ|آھوڙجڻ
آهوڙڻ|آھوڙڻ
آهوڙو|آھوڙو
آهوڙي|آھوڙي
آهوشڪم|آھوشڪم
آهون|آھون
آهونگاه|آھونگاھ
آهوي|آھوي
آهي|آھي
آهيج|آھيج
آهير|آھير
آهيرو|آھيرو
آهيري|آھيري
آهيريان|آھيريان
آهيريو|آھيريو
آهيڙو|آھيڙو
آهيڙي|آھيڙي
آهيڙياڻي|آھيڙياڻي
آهيڙياڻِيوُن|آھيڙياڻِيوُن
آهين|آھين
آهينو|آھينو
آھه|آھہ
آھھ|آھہ
آواره|آوارہ
آوازه|آوازہ
آواگهر|آواگهر
آواگهين|آواگهين
آواهن|آواھن
آوه|آوہ
آوهه|آوھہ
آينده|آيندہ
ائمه|ائمه
اباهڻ|اباھڻ
ابتهاج|ابتھاج
ابتهال|ابتھال
ابخره|ابخرہ
ابراهيم|ابراھيم
ابراهيمي|ابراھيمي
ابره|ابرھ
ابرهو|ابرھو
ابلهانه|ابلھانہ
ابلهه|ابلھ
ابلهي|ابلھي
ابليسانه|ابليسانہ
ابهام|ابھام
ابهايو|ابھايو
ابهر|ابھر
ابهڪ|ابھڪ
ابهم|ابھم
ابهڻ|ابھڻ
ابهو|ابھو
ابوالهول|ابوالھول
اٻاجھو|اٻاجهو
اٻاهر|اٻاھر
اٻاهرو|اٻاھرو
اٻاهو|اٻاھو
اٻاهي|اٻاھي
اٻجهه|اٻجهہ
اٻڙهه|اٻڙھ
اٻهارجڻ|اٻھارجڻ
اٻهر|اٻھر
اٻهرائي|اٻھرائي
اٻهرو|اٻھرو
اٻهري|اٻھري
اٻهڙ|اٻھڙ
اٻوجهه|اٻوجهہ
اٻوجھاء|اٻوجهاء
اٻوجھائي|اٻوجهائي
اٻوجھاڻو|اٻوجهاڻو
اٻوجھه|اٻوجھہ
اٻوجھھ|اٻوجھہ
اٻوجھو|اٻوجهو
اٻوهيو|اٻوھيو
اپائڻهار|اپائڻھار
اپاهت|اپاھت
اپاهج|اپاھج
اپاهڪ|اپاھڪ
اپاهڪي|اپاھڪي
اپگرهه|اپگرھ
اپهتو|اپھتو
اپهچ|اپھچ
اپهس|اپھس
اپهڪ|اپھڪ
اپهڪي|اپھڪي
اپهو|اپھو
اڀساهي|اڀساھي
اڀهو|اڀھو
اڀيهڻ|اڀيھڻ
اتانگهه|اتانگهہ
اتانگھه|اتانگهہ
اتانگھو|اتانگهو
اتانهم|اتانھم
اتانهون|اتانھون
اتانهين|اتانھين
اتاهل|اتاھل
اتاهه|اتاھ
اتسئه|اتسئہ
اتساهه|اتساھ
اتساهي|اتساھي
اتفاقيه|اتفاقيہ
اتنگهه|اتنگهہ
اتنگھه|اتنگهہ
اتنگھي|اتنگهي
اتهاس|اتھاس
اتّهام|اتّھام
اتهين|اتھين
اتيهاس|اتيھاس
اتيهڻ|اتيھڻ
اٺارهن|اٺارھن
اٺاويهه|اٺاويھہ
اٺاويهو|اٺاويھو
اٺٽيهه|اٺٽيھ
اٺهتر|اٺھتر
اٺهٺ|اٺھٺ
اٺهريو|اٺھريو
اٺهن|اٺھن
اٺونجاهه|اٺونجاھ
اٺيتاليهه|اٺيتاليھہ
اٽهائيندو|اٽھائيندو
اٽّهاس|اٽّھاس
اٽهلو|اٽھلو
اٽهه|اٽھ
اٽوڙهڻ|اٽوڙھڻ
اٿاهه|اٿاھ
اٿاھھ|اٿاھہ
اٿهون|اٿھون
اجاره|اجارہ
اجارهء|اجارہء
اجتهاد|اجتھاد
اجهه|اجهہ
اجھا|اجها
اجھائڻ|اجهائڻ
اجھائي|اجهائي
اجھاپ|اجهاپ
اجھار|اجهار
اجھارڻ|اجهارڻ
اجھاڪي|اجهاڪي
اجھاڳ|اجهاڳ
اجھاڳو|اجهاڳو
اجھال|اجهال
اجھالڪو|اجهالڪو
اجھام|اجهام
اجھامڻ|اجهامڻ
اجھان|اجهان
اجھرڻ|اجهرڻ
اجھڙڪڻ|اجهڙڪڻ
اجھڙڻ|اجهڙڻ
اجھڪ|اجهڪ
اجھڪائي|اجهڪائي
اجھڪو|اجهڪو
اجھل|اجهل
اجھلائي|اجهلائي
اجھندو|اجهندو
اجھڻ|اجهڻ
اجھه|اجهہ
اجھو|اجهو
اجھور|اجهور
اجھورو|اجهورو
اجھوڪو|اجهوڪو
اجھول|اجهول
اجھي|اجهي
اجوره|اجورہ
اڄلهه|اڄلهہ
اڄهندو|اڄھندو
اڄهڻ|اڄھڻ
اڄهه|اڄھہ
اڄھه|اڄھہ
اچاهه|اچاھ
اچهري|اچھري
اچهون|اچھون
اڇاهرائي|اڇاھرائي
اڇاهرو|اڇاھرو
اڇهرو|اڇھرو
اڇهري|اڇھري
احمقانه|احمقانہ
اختيارانه|اختيارانہ
ادبانه|ادبانہ
ادعيه|ادعيہ
ادله|ادلہ
ادهم|ادھم
ادهه|ادھہ
ادوهو|ادوھو
ادويه|ادويہ
اذهان|اذھان
اڊلهه|اڊلهہ
اڊلھه|اڊلهہ
اڌهڻ|اڌھڻ
اڏهي|اڏھي
اڏوهو|اڏوھو
اڏوهي|اڏوھي
اڏيهي|اڏيھي
ارابه|ارابہ
اراده|ارادہ
ارتوهارڻ|ارتوھارڻ
ارجهه|ارجهہ
ارجھڻ|ارجهڻ
ارجھه|ارجهہ
ارجھو|ارجهو
ارفاھھ|ارفاھ
ارگهه|ارگهہ
ارگھا|ارگها
ارمله|ارملہ
اره|ارھ
ارهائڻ|ارھائڻ
ارهائي|ارھائي
ارهاٽ|ارھاٽ
ارهاٽڻ|ارھاٽڻ
ارهال|ارھال
ارهاڻ|ارھاڻ
ارهاڻو|ارھاڻو
ارهاڻي|ارھاڻي
ارهجڻ|ارھجڻ
ارهر|ارھر
ارهن|ارھن
ارهندائي|ارھندائي
ارهندو|ارھندو
ارهندي|ارھندي
ارهنڪو|ارھنڪو
ارهڻ|ارھڻ
ارهه|ارھہ
ارهو|ارھو
ارهون|ارھون
ارهي|ارھي
ارونهرو|ارونھرو
ارينهڪو|ارينھڪو
ارينهن|ارينھن
ازالئه|ازالئہ
ازدها|ازدھا
ازهار|ازھار
اڙهني|اڙھني
اڙهڻ|اڙھڻ
اسئله|اسئلہ
اساتذه|اساتذہ
اسامه|اسامہ
اسانهين|اسانھين
استاده|استادہ
استغاثه|استغاثہ
استفاده|استفادہ
استفاضه|استفاضہ
استفهام|استفھام
استفهامي|استفھامي
استڪراهه|استڪراھ
استهزاء|استھزاء
اسڪندريه|اسڪندريہ
اسگاهه|اسگاھ
اسگھائي|اسگهائي
اسگھٽي|اسگهٽي
اسگھو|اسگهو
اسلحه|اسلحہ
اسليه|اسليہ
اسماعيليه|اسماعيليہ
اسمجهه|اسمجهہ
اسمجھه|اسمجهہ
اسنهون|اسنھون
اسنهين|اسنھين
اسهارو|اسھارو
اسهال|اسھال
اسهج|اسھج
اسهڪار|اسھڪار
اسهل|اسھل
اسهڻ|اسھڻ
اسهه|اسھہ
اسهو|اسھو
اسوجهه|اسوجهہ
اسونهه|اسونهہ
اسونهون|اسونھون
اسونهين|اسونھين
اسوه|اسوہ
اشاره|اشارہ
اشاعره|اشاعرہ
اشباهه|اشباھ
اشتباهه|اشتباھ
اشتباهي|اشتباھي
اشتها|اشتھا
اشتهار|اشتھار
اشڪره|اشڪرہ
اشهاد|اشھاد
اشهب|اشھب
اشهد|اشھد
اشهر|اشھر
اصفهان|اصفھان
اصلحه|اصلحہ
اطهار|اطھار
اطهر|اطھر
اظهار|اظھار
اظهر|اظھر
اعجوبه|اعجوبہ
افاده|افادہ
افتاده|افتادہ
افروخته|افروختہ
افروزه|افروزہ
افسانه|افسانہ
افسرده|افسردہ
افسردھ|افسردہ
افواه|افواھ
افواهي|افواھي
اقباله|اقبالہ
اڪارهن|اڪارھن
اڪانجهر|اڪانجهر
اڪانهن|اڪانھن
اڪانهه|اڪانھ
اڪراه|اڪراھ
اڪرنجهه|اڪرنجهہ
اڪهڻو|اڪھڻو
اڪهه|اڪھہ
اڪولاهي|اڪولاھي
اڪونجهه|اڪونجهہ
اڪوهي|اڪوھي
اگرچه|اگرچہ
اگھائتو|اگهائتو
اگھائجڻ|اگهائجڻ
اگھائڻ|اگهائڻ
اگھائي|اگهائي
اگھاتو|اگهاتو
اگھار|اگهار
اگھاري|اگهاري
اگھاڙ|اگهاڙ
اگھاڙا|اگهاڙا
اگھاڙائي|اگهاڙائي
اگھاڙپ|اگهاڙپ
اگھاڙڻ|اگهاڙڻ
اگھاڙو|اگهاڙو
اگھاڙي|اگهاڙي
اگھاماڻو|اگهاماڻو
اگھاماڻي|اگهاماڻي
اگھامتي|اگهامتي
اگھامجڻ|اگهامجڻ
اگھامڻ|اگهامڻ
اگھتائي|اگهتائي
اگھٺڻ|اگهٺڻ
اگھٽ|اگهٽ
اگھٽجڻ|اگهٽجڻ
اگھٽڻ|اگهٽڻ
اگھر|اگهر
اگھراڻي|اگهراڻي
اگھرجو|اگهرجو
اگھرو|اگهرو
اگھڙ|اگهڙ
اگھڙن|اگهڙن
اگھل|اگهل
اگھلجڻ|اگهلجڻ
اگھلڻ|اگهلڻ
اگھلو|اگهلو
اگھلي|اگهلي
اگھم|اگهم
اگھن|اگهن
اگھڻ|اگهڻ
اگھڻو|اگهڻو
اگھھ|اگهہ
اگھو|اگهو
اگھوتر|اگهوتر
اگھوتري|اگهوتري
اگھوچر|اگهوچر
اگھور|اگهور
اگھورپڻو|اگهورپڻو
اگھوڙ|اگهوڙ
اگھي|اگهي
اگھير|اگهير
اگھيري|اگهيري
اگھيم|اگهيم
اگھيماڻي|اگهيماڻي
اگھيھ|اگهيہ
اگوھڻ|اگوھڻ
اڳانجھھ|اڳانجهہ
اڳانجھو|اڳانجهو
اڳانهن|اڳانھن
اڳانهه|اڳانھہ
اڳاهون|اڳاھون
اڳاهين|اڳاھين
اڳهرو|اڳھرو
اڳهڙو|اڳھڙو
اڳهڙي|اڳھڙي
اڳهن|اڳھن
اڳهڻ|اڳھڻ
اڳهڻو|اڳھڻو
اڳهه|اڳھہ
اڳهوڙي|اڳھوڙي
اڳهون|اڳھون
اڳهين|اڳھين
اڳهيو|اڳھيو
اڳواهي|اڳواھي
اڳواهيو|اڳواھيو
اڳوهڻ|اڳوھڻ
اڳوهيو|اڳوھيو
اڳيراهون|اڳيراھون
الئه|الئہ
الاقامه|الاقامہ
الاّلله|الاّلله
الاها|الاھا
الاهر|الاھر
الاهڻ|الاھڻ
الاهڻو|الاھڻو
الاهه|الاھ
الاهو|الاھو
الاهي|الاھي
الاهيات|الاھيات
الاهيت|الاھيت
الاهيو|الاھيو
البديهه|البديھہ
البّوبه|البّوبہ
الجمله|الجملہ
الجهڻ|الجهڻ
الدهر|الدھر
الذمه|الذمہ
الڊهه|الڊھہ
الريهه|الريھہ
الڙهڪڻ|الڙھڪڻ
السنه|السنہ
الشهداء|الشھداء
القصه|القصہ
الڪوهل|الڪوھل
المنتهيٰ|المنتھيٰ
المهام|المھام
النگھڻ|النگهڻ
النگھين|النگهين
الهام|الھام
الهضم|الھضم
الهندو|الھندو
الهندي|الھندي
الهڻ|الهڻ
الهه|الهه
الٰهه|الٰھ
الهو|الهو
الهوٽ|الهوٽ
الهي|الهي
الٰهي|الٰھي
الهيثم|الھيثم
الهيڙ|الھيڙ
الھائڻ|الهائڻ
الھارڻ|الهارڻ
الھاڻ|الهاڻ
الھاڻو|الهاڻو
الھايو|الهايو
الھٽ|الهٽ
الھجي|الهجي
الھراسي|الهراسي
الھڙ|الهڙ
الونهه|الونھہ
الوهوٽ|الوھوٽ
الوهيت|الوھيت
اليه|اليہ
اليهر|اليھر
اليَهُودِ|اليَھُودِ
اماله|اماله
اماميه|اماميہ
امانگھرو|امانگهرو
اماهڻ|اماھڻ
اماهي|اماھي
امجھڻ|امجهڻ
امجھو|امجهو
امرالاهي|امرالاھي
امرنهي|امرنھي
امروهي|امروھي
امڪنه|امڪنہ
املهه|املهہ
املھه|املهہ
امهات|امھات
امهڙو|امھڙو
امھائڻ|امهائڻ
امھاڙي|امهاڙي
امونگهه|امونگهہ
امونگھه|امونگهہ
اميه|اميہ
اناطوليه|اناطوليہ
انبوهناڪ|انبوھناڪ
انبوهه|انبوھ
انبوهي|انبوھي
انتباهه|انتباھ
انتها|انتھا
انجهه|انجهہ
انداهه|انداھ
انداهي|انداھي
اندروهه|اندروھ
اندوخته|اندوختہ
اندوراهه|اندوراھ
اندوهگين|اندوھگين
اندوهناڪ|اندوھناڪ
اندوهه|اندوھہ
انديشه|انديشه
انڌڳهو|انڌڳھو
انگھائڻ|انگهائڻ
انگھائي|انگهائي
انگھر|انگهر
انگھرو|انگهرو
انگھڙي|انگهڙي
انگھن|انگهن
انگھڻ|انگهڻ
انگھھ|انگهہ
انگھو|انگهو
انگھون|انگهون
انگھي|انگهي
انگيخته|انگيختہ
انهان|انھان
انهد|انھد
انهدام|انھدام
انهدي|انھدي
انهڪارڻ|انھڪارڻ
انهم|انھم
انهماڪ|انھماڪ
انهه|انهہ
انهوارجڻ|انھوارجڻ
انهي|انھي
انهيء|انھيء
انهيار|انهيار
انهيري|انهيري
اڻاهٺ|اڻاھٺ
اڻپڙهيو|اڻپڙهيو
اڻٺاهه|اڻٺاھ
اڻٺهندي|اڻٺھندي
اڻٺهڻو|اڻٺھڻو
اڻٺهيو|اڻٺھيو
اڻٽيهه|اڻٽيھ
اڻگهيل|اڻگهيل
اڻهار|اڻھار
اڻهتر|اڻھتر
اڻهٺ|اڻھٺ
اڻهن|اڻھن
اڻهول|اڻھول
اڻهي|اڻھي
اڻهيار|اڻھيار
اڻونجاهه|اڻونجاھ
اڻويهه|اڻويھ
اڻويهين|اڻويھين
اڻيتاليهه|اڻيتاليھ
اڻيهه|اڻيھ
اهئين|اھئين
اها|اھا
اهاء|اھاء
اهائو|اھائو
اهائي|اھائي
اهار|اھار
اهارڻ|اھارڻ
اهارو|اھارو
اهاري|اھاري
اهاڙ|اھاڙ
اهانت|اھانت
اهب|اھب
اهٻڏو|اھٻڏو
اهپارو|اھپارو
اهت|اھت
اهتمام|اھتمام
اهتي|اھتي
اهٿرو|اھٿرو
اهج|اھج
اهجو|اھجو
اهڃ|اھڃ
اهڃائو|اھڃائو
اهڃاڻ|اھڃاڻ
اهڃاڻو|اھڃاڻو
اهڄائي|اھڄائي
اهڄو|اھڄو
اهدي|اھدي
اهڏ|اھڏ
اهڏڻ|اھڏڻ
اهر|اھر
اهرائڻ|اھرائڻ
اهرام|اھرام
اهرجڻ|اھرجڻ
اهرمن|اھرمن
اهرڻ|اھرڻ
اهرو|اھرو
اهري|اھري
اهريانئون|اھريانئون
اهرياڻو|اھرياڻو
اهريو|اھريو
اهڙ|اھڙ
اهڙامار|اھڙامار
اهڙو|اھڙو
اهڙيء|اھڙيء
اهس|اھس
اهک|اھک
اهکائي|اھکائي
اهکو|اھکو
اهڪار|اھڪار
اهگ|اھگ
اهڳ|اھڳ
اهڳور|اھڳور
اهل|اھل
اهلجڻ|اھلجڻ
اهلڪار|اھلڪار
اهلڻ|اھلڻ
اهلون|اھلون
اهلي|اھلي
اهليت|اھليت
اهلير|اھلير
اهليه|اھليه
اهم|اھم
اهمائڻ|اھمائڻ
اهمائي|اھمائي
اهمال|اھمال
اهمايل|اھمايل
اهمڻ|اھمڻ
اهمو|اھمو
اهمي|اھمي
اهميت|اھميت
اهن|اھن
اهنج|اھنج
اهنجائتو|اھنجائتو
اهنجائي|اھنجائي
اهنجو|اھنجو
اهندر|اھندر
اهندڙ|اھندڙ
اهنڊ|اھنڊ
اهنڊر|اھنڊر
اهنڊو|اھنڊو
اهنر|اھنر
اهنسا|اھنسا
اهنسڪ|اھنسڪ
اهنڪار|اھنڪار
اهنگ|اھنگ
اهنو|اھنو
اهنوارجڻ|اھنوارجڻ
اهنوتري|اھنوتري
اهنوڙي|اھنوڙي
اهنير|اھنير
اهڻا|اھڻا
اهڻو|اھڻو
اهه|اھ
اهو|اھو
اهوئي|اھوئي
اهواڳ|اھواڳ
اهواڳين|اھواڳين
اهوڙ|اھوڙ
اهوسهو|اھوسھو
اهون|اھون
اهي|اھي
اهير|اھير
اهيرڻ|اھيرڻ
اهيڙو|اھيڙو
اهيڙي|اھيڙي
اهيل|اھيل
اهين|اھين
اهيڻي|اھيڻي
اواجهو|اواجهو
اواهه|اواھ
اوباهجڻ|اوباھجڻ
اوباهڻ|اوباھڻ
اوباهه|اوباھ
اوباهو|اوباھو
اوٻاهي|اوٻاھي
اوٻهارو|اوٻھارو
اوٻهرو|اوٻھرو
اوڀاهڻ|اوڀاھڻ
اوجهر|اوجهر
اوجهراڙ|اوجهراڙ
اوجهراڪي|اوجهراڪي
اوجهراڪيون|اوجهراڪيون
اوجهراڻي|اوجهراڻي
اوجهراڻيون|اوجهراڻيون
اوجهرڻ|اوجهرڻ
اوجهرو|اوجهرو
اوجهري|اوجهري
اوجهريء|اوجهريء
اوجهڙ|اوجهڙ
اوجهڙاڙو|اوجهڙاڙو
اوجهڻو|اوجهڻو
اوجهه|اوجهہ
اوڃهه|اوڃھ
اوڄاهه|اوڄاھ
اوڄهه|اوڄھ
اوچيهر|اوچيھر
اوڏانهن|اوڏانهن
اوڏانهون|اوڏانهون
اوڏاهم|اوڏاھم
اوڏاهون|اوڏاھون
اوڏاهين|اوڏاھين
اورانگهڻ|اورانگهڻ
اورانگهه|اورانگهہ
اوراهون|اوراھون
اورتاهون|اورتاھون
اورنباهڻ|اورنباھڻ
اورنگشاهي|اورنگشاھي
اورنگهه|اورنگهہ
اورهاٽڻ|اورھاٽڻ
اورهاڙو|اورھاڙو
اورهٽ|اورھٽ
اورهه|اورھ
اورهون|اورھون
اوڙاهه|اوڙاھ
اوڙاھھ|اوڙاھہ
اوڙيهر|اوڙيھر
اوسهه|اوسھہ
اوگاهه|اوگاھ
اوگاهي|اوگاھي
اوگهٽ|اوگهٽ
اوگهٽو|اوگهٽو
اوگهر|اوگهر
اوگهرجڻ|اوگهرجڻ
اوگهرڻ|اوگهرڻ
اوگهڙ|اوگهڙ
اوگهڙيون|اوگهڙيون
اوگهم|اوگهم
اوگهمو|اوگهمو
اوگهه|اوگهہ
اوگهو|اوگهو
اوگهيتو|اوگهيتو
اولانگهه|اولانگهہ
اولهه|اولھ
اولھه|اولھہ
اوليهي|اوليھي
اوماهي|اوماھي
اومهرو|اومھرو
اونجهر|اونجهر
اونجهرڻ|اونجهرڻ
اونجهڻ|اونجهڻ
اوندآھه|اوندآھہ
اونداهه|اونداھ
اونداهو|اونداھو
اونداهي|اونداھي
اونداھه|اونداھہ
اونده|اوندھ
اوندهه|اوندھہ
اوندھھ|اوندھہ
اونڌهه|اونڌھہ
اونگهائي|اونگهائي
اونگهاڙ|اونگهاڙ
اونگهاس|اونگهاس
اونگهاڻو|اونگهاڻو
اونگهرڻ|اونگهرڻ
اونگهڻ|اونگهڻ
اونگهه|اونگهہ
اونگهو|اونگهو
اونها|اونها
اونهائي|اونهائي
اونهارو|اونهارو
اونهاڙ|اونهاڙ
اونهاڻ|اونهاڻ
اونهر|اونهر
اونهڻ|اونهڻ
اونهه|اونهہ
اونهو|اونهو
اونهون|اونهون
اونهين|اونهين
اوڻٽيهه|اوڻٽيھ
اوڻٽيهين|اوڻٽيھين
اوڻهتر|اوڻھتر
اوڻهٺ|اوڻھٺ
اوڻونجاهه|اوڻونجاھ
اوڻيتاليهه|اوڻيتاليھہ
اوڻيهه|اوڻيھہ
اوڻيهون|اوڻيھون
اوه|اوھ
اوهئين|اوھئين
اوها|اوھا
اوهار|اوھار
اوهارجڻ|اوھارجڻ
اوهارڻ|اوھارڻ
اوهارو|اوھارو
اوهاڙ|اوھاڙ
اوهام|اوھام
اوهاندو|اوھاندو
اوهجڻ|اوھجڻ
اوهر|اوھر
اوهرائڻ|اوھرائڻ
اوهرجڻ|اوھرجڻ
اوهرڻ|اوھرڻ
اوهڙ|اوھڙ
اوهمائي|اوھمائي
اوهمو|اوھمو
اوهنائي|اوھنائي
اوهنو|اوھنو
اوهه|اوھ
اوهو|اوھو
اوهي|اوھي
اوهير|اوھير
اوهيرا|اوھيرا
اوهيرو|اوھيرو
اوهين|اوھين
اويساهه|اويساھ
ايجهو|ايجهو
ايڏانهن|ايڏانھن
ايڏانهون|ايڏانھون
ايڏانهين|ايڏانھين
ايڏتانهون|ايڏتانھون
ايڏتانهين|ايڏتانھين
ايڏهان|ايڏھان
ايڏهون|ايڏھون
ايڏهين|ايڏھين
ايستاده|ايستادھ
ايڪاهٺ|ايڪاھٺ
ايڪٽيهه|ايڪٽيھہ
ايڪهتر|ايڪھتر
ايڪهٺ|ايڪھٺ
ايڪهڻا|ايڪھڻا
ايڪهڻو|ايڪھڻو
ايڪونجاهه|ايڪونجاھ
ايڪويهه|ايڪويھہ
ايڪيتاليهه|ايڪيتاليھہ
ايڪيهه|ايڪيھہ
ايلاهه|ايلاھ
ايلاهون|ايلاھون
ايلهه|ايلهہ
اينگهائڻ|اينگهائڻ
اينگهڻ|اينگهڻ
اينگهه|اينگهہ
ايننهن|ايننھن
اينهار|اينھار
اينوهه|اينوھ
ايها|ايھا
ايهار|ايھار
ايهام|ايھام
ايهان|ايھان
ايهر|ايھر
ايهرو|ايھرو
ايهنس|ايھنس
ايهو|ايھو
بابهه|بابھہ
باتشاهه|باتشاھ
باتشاهي|باتشاھي
باجهاڻي|باجهاڻي
باچاڙهڻ|باچاڙهڻ
باڇاهه|باڇاھ
باڇاهي|باڇاھي
باڇاهيون|باڇاھيون
باخته|باختہ
بادبهار|بادبھار
بادرنجبويه|بادرنجبويہ
بادشاه|بادشاھ
بادشاهاڻو|بادشاھاڻو
بادشاهت|بادشاھت
بادشاهزادو|بادشاھزادو
بادشاهڻ|بادشاھڻ
بادشاهه|بادشاھ
بادشاهي|بادشاھي
باده|بادہ
باديه|باديہ
باڊهه|باڊھ
بارجه|بارجہ
بارگاه|بارگاھ
باره|بارہ
بارها|بارھا
بازگهاء|بازگهاء
بازيگاه|بازيگاھ
باسليقه|باسليقہ
باصره|باصرہ
باطنيه|باطنيہ
بافنده|بافندہ
باقاعده|باقاعدہ
باڪره|باڪرہ
باگواهه|باگواھ
باگوڊهو|باگوڊھو
باڳهه|باڳهہ
بالجمله|بالجملہ
بالمشافهة|بالمشافھة
بالمشاهده|بالمشاھدہ
بالمقابله|بالمقابلہ
بالمقطعه|بالمقطعہ
بالمناصفه|بالمناصفہ
بالمواجهة|بالمواجھة
بالهڙو|بالھڙو
بالواسطه|بالواسطه
بالوشاهي|بالوشاھي
بامگاه|بامگاہ
بانداهو|بانداھو
بانگهو|بانگهو
باڻاهه|باڻاھ
باهرئون|باھرئون
باهروٽيو|باھروٽيو
باهڙ|باھڙ
باهڙائڻ|باھڙائڻ
باهڙجڻ|باھڙجڻ
باهڙڻ|باھڙڻ
باهمت|باھمت
باهمه|باھمہ
باهمي|باھمي
باهڻ|باھڻ
باهه|باهہ
باهو|باھو
باهوٽو|باھوٽو
باهوٽي|باھوٽي
باهوڙ|باھوڙ
باهوڙڻ|باھوڙڻ
باهين|باھين
باهيون|باھيون
بجنسه|بجنسہ
بجهڪائڻ|بجهڪائڻ
بجهڪڻ|بجهڪڻ
بچائڻهار|بچائڻھار
بچه|بچہ
بحمده|بحمده
بحيره|بحيرہ
بخشاهه|بخشاھ
بخشنده|بخشندہ
بخشڻهار|بخشڻھار
بداهت|بداھت
بدپيشه|بدپيشہ
بدراهه|بدراھ
بدگهر|بدگهر
بدلواهه|بدلواھ
بدمزه|بدمزہ
بدنهاد|بدنھاد
بدهاضمو|بدھاضمو
بدهضمي|بدهضمي
بدهيئت|بدهيئت
بديهه|بديھہ
بديهي|بديھي
بذله|بذلہ
برادرانه|برادرانہ
براه|براہ
براهماڻي|براھماڻي
براهوئي|براھوئي
براهي|براھي
برجسته|برجستہ
برداشته|برداشتہ
برده|بردہ
برطانيه|برطانيہ
برگشته|برگشتہ
برلاهڻ|برلاھڻ
برمه|برمہ
برهاري|برھاري
برهان|برھان
برهرو|برھرو
برهسپت|برھسپت
برهم|برھم
برهما|برھما
برهماراتڙي|برھماراتڙي
برهمانند|برھمانند
برهماڻي|برھماڻي
برهمپترا|برھمپترا
برهمچاري|برھمچاري
برهمچريه|برھمچريہ
برهمني|برھمني
برهمڻ|برھمڻ
برهمڻو|برھمڻو
برهمو|برھمو
برهمي|برھمي
برهنگي|برھنگي
برهنه|برھنہ
برهه|برھ
برهو|برھو
برهي|برھي
برھھ|برھہ
بروهي|بروھي
بريده|بريدہ
بريه|بريہ
بزرجمهر|بزرجمھر
بزرگانه|بزرگانہ
بزرگوارانه|بزرگوارانہ
بزغاله|بزغالہ
بزڪوهي|بزڪوھي
بزمگاهه|بزمگاھہ
بڙهاٽ|بڙھاٽ
بڙهه|بڙھہ
بسته|بستہ
بسيهر|بسيھر
بشره|بشرہ
بشيهر|بشيھر
بعده|بعدہ
بعينه|بعينہ
بقره|بقرہ
بقعه|بقعہ
بقيه|بقيہ
بڪه|بڪہ
بگهاڙ|بگهاڙ
بگهاڙي|بگهاڙي
بگهڙ|بگهڙ
بگهڙپوڻ|بگهڙپوڻ
بگهڙي|بگهڙي
بگهياڙ|بگهياڙ
بگهياڙو|بگهياڙو
بگهياڙي|بگهياڙي
بگهياڙيون|بگهياڙيون
بگهيڙ|بگهيڙ
بلاتشبيه|بلاتشبيہ
بلازده|بلازدہ
بلاشاه|بلاشاھ
بلافائده|بلافائدہ
بلاهت|بلاھت
بلاهه|بلاھہ
بلاواسطه|بلاواسطہ
بلاوجه|بلاوجہ
بلده|بلدہ
بلديه|بلديہ
بلغاريه|بلغاريہ
بلڪه|بلڪہ
بلهزير|بلھزير
بلهه|بلھہ
بليغانه|بليغانہ
بمهر|بمھر
بناهه|بناھ
بناهو|بناھو
بنجهو|بنجهو
بنجهوء|بنجهوء
بندراهو|بندراھو
بنده|بندہ
بنراهه|بنراھ
بنگله|بنگلہ
بنهر|بنھر
بنهن|بنھن
بنهي|بنھي
بنيهه|بنيھہ
به|بہ
بها|بھا
بهاء|بھاء
بهائم|بھائم
بهائڻ|بھائڻ
بهائي|بھائي
بهاب|بھاب
بهادر|بھادر
بهادرانه|بھادرانہ
بهادراڻي|بھادراڻي
بهادرپور|بھادرپور
بهادري|بھادري
بهار|بھار
بهارجڻ|بھارجڻ
بهارستان|بھارستان
بهارڻ|بھارڻ
بهارو|بھارو
بهارون|بھارون
بهاري|بھاري
بهاريه|بھاريہ
بهاڳ|بھاڳ
بهانائي|بھانائي
بهانه|بھانہ
بهانو|بھانو
بهاني|بھاني
بهاول|بھاول
بهاولپور|بھاولپور
بهبود|بھبود
بهبودي|بھبودي
بهتان|بھتان
بهتانو|بھتانو
بهتاني|بھتاني
بهتر|بھتر
بهتري|بھتري
بهترين|بھترين
بهجت|بھجت
بهدور|بھدور
بهر|بھر
بهرام|بھرام
بهرامي|بھرامي
بهراڻو|بھراڻو
بهراڻي|بھراڻي
بهرحال|بھرحال
بهرخدا|بھرخدا
بهره|بھرہ
بهرو|بھرو
بهروند|بھروند
بهري|بھري
بهريون|بھريون
بهڙ|بھڙ
بهڙائڻ|بھڙائڻ
بهڙڻ|بھڙڻ
بهڙي|بھڙي
بهستي|بھستي
بهسڻ|بھسڻ
بهش|بھش
بهشت|بھشت
بهشتي|بھشتي
بهشڪار|بھشڪار
بهشي|بھشي
بهشير|بھشير
بهڪ|بھڪ
بهڪائڻ|بھڪائڻ
بهڪڻ|بھڪڻ
بهلائڻ|بھلائڻ
بهلاڻي|بھلاڻي
بهلڪاڻي|بھلڪاڻي
بهلور|بھلور
بهلول|بھلول
بهلولاڻي|بھلولاڻي
بهليم|بھليم
بهم|بھم
بهمن|بھمن
بهمني|بھمني
بهمڻ|بھمڻ
بهڻ|بھڻ
بهه|بھہ
بهو|بھو
بهور|بھور
بهورجڻ|بھورجڻ
بهي|بھي
بهير|بھير
بهيماڻي|بھيماڻي
بهيمه|بھيمہ
بهيمي|بھيمي
بهين|بھين
بهيڻ|بھيڻ
بهيون|بھيون
بھ|بہ
بوالهوس|بوالھوس
بوالهوسي|بوالھوسي
بوجهو|بوجهو
بوزنه|بوزنہ
بوزينه|بوزينہ
بوسه|بوسہ
بونگاهه|بونگاھہ
بونهڻ|بونھڻ
بوهار|بوھار
بوهارجڻ|بوھارجڻ
بوهارو|بوھارو
بوهاڙجڻ|بوھاڙجڻ
بوهر|بوھر
بوهرا|بوھرا
بوهرو|بوھرو
بوهري|بوھري
بوهڙ|بوھڙ
بوهڙڪي|بوھڙڪي
بوهڻ|بوھڻ
بوهي|بوھي
بوهيارو|بوھيارو
بيپرواهه|بيپرواھہ
بيپرواهي|بيپرواھي
بيجهه|بيجهہ
بيراهه|بيراھ
بيرهن|بيرھن
بيرهه|بيرھہ
بيگانه|بيگانہ
بيگاهه|بيگاھہ
بينجهه|بينجهہ
بيهارڻ|بيھارڻ
بيهڪ|بيھڪ
بيهلو|بيھلو
بيهڻ|بيھڻ
بيهه|بيھہ
بيهودگي|بيھودگي
بيهودو|بيھودو
بيهي|بيھي
بيهيداڻو|بيھيداڻو
بيوه|بيوہ
ٻائيتاليهه|ٻائيتاليھہ
ٻاٻهه|ٻاٻھہ
ٻاٻيها|ٻاٻيھا
ٻاٻيهل|ٻاٻيھل
ٻاٻيهه|ٻاٻيھہ
ٻاٻيهو|ٻاٻيھو
ٻاٽيهڙ|ٻاٽيھڙ
ٻاجهائتو|ٻاجهائتو
ٻاجهائڻ|ٻاجهائڻ
ٻاجهائي|ٻاجهائي
ٻاجهارو|ٻاجهارو
ٻاجهان|ٻاجهان
ٻاجهاڻو|ٻاجهاڻو
ٻاجهٽ|ٻاجهٽ
ٻاجهر|ٻاجهر
ٻاجهرو|ٻاجهرو
ٻاجهري|ٻاجهري
ٻاجهريو|ٻاجهريو
ٻاجهنئن|ٻاجهنئن
ٻاجهندڙ|ٻاجهندڙ
ٻاجهڻ|ٻاجهڻ
ٻاجهه|ٻاجهہ
ٻاجهو|ٻاجهو
ٻاجهوڪ|ٻاجهوڪ
ٻاجهون|ٻاجهون
ٻاجهيندڙ|ٻاجهيندڙ
ٻاجھھ|ٻاجھہ
ٻاراهڻي|ٻاراھڻي
ٻاراهو|ٻاراھو
ٻاراهي|ٻاراھي
ٻارهن|ٻارھن
ٻارهو|ٻارھو
ٻارهوئي|ٻارھوئي
ٻارهون|ٻارھون
ٻارهي|ٻارھي
ٻارهين|ٻارھين
ٻاروهي|ٻاروھي
ٻاڙهي|ٻاڙھي
ٻاڙهيون|ٻاڙھيون
ٻاڙياپنهور|ٻاڙياپنھور
ٻاگهل|ٻاگهل
ٻاگهلاڻي|ٻاگهلاڻي
ٻاگهه|ٻاگهہ
ٻاگهي|ٻاگهي
ٻاليشاهي|ٻاليشاھي
ٻانڀڻاهه|ٻانڀڻاھ
ٻانڀڻياهه|ٻانڀڻياھ
ٻانڀيهڙ|ٻانڀيهڙ
ٻانگهه|ٻانگهہ
ٻانهنرکي|ٻانهنرکي
ٻانهوٽ|ٻانھوٽ
ٻانهوٽو|ٻانھوٽو
ٻانهوٽي|ٻانھوٽي
ٻانهوڙي|ٻانھوڙي
ٻانهون|ٻانھون
ٻانهياري|ٻانھياري
ٻانهيٽي|ٻانھيٽي
ٻانهين|ٻانھين
ٻانھا|ٻانها
ٻانھپ|ٻانهپ
ٻانھپائي|ٻانهپائي
ٻانھپڻ|ٻانهپڻ
ٻانھپڻو|ٻانهپڻو
ٻانھپو|ٻانهپو
ٻانھرو|ٻانھرو
ٻانھڙ|ٻانهڙ
ٻانھڙو|ٻانهڙو
ٻانھن|ٻانهن
ٻانھو|ٻانهو
ٻانھوانجرو|ٻانهوانجرو
ٻاه|ٻاہ
ٻاهتر|ٻاھتر
ٻاهتري|ٻاھتري
ٻاهتريائي|ٻاھتريائي
ٻاهتريو|ٻاھتريو
ٻاهٺ|ٻاھٺ
ٻاهر|ٻاھر
ٻاهرئين|ٻاھرئين
ٻاهراري|ٻاھراري
ٻاهراڙي|ٻاھراڙي
ٻاهراڙيون|ٻاھراڙيون
ٻاهران|ٻاھران
ٻاهرتو|ٻاھرتو
ٻاهرتي|ٻاھرتي
ٻاهرو|ٻاھرو
ٻاهري|ٻاھري
ٻاهرين|ٻاھرين
ٻاهريو|ٻاھريو
ٻاهريون|ٻاھريون
ٻاهڙميرا|ٻاھڙميرا
ٻاهڙو|ٻاھڙو
ٻاهڻ|ٻاھڻ
ٻاهو|ٻاھو
ٻاهوڙي|ٻاھوڙي
ٻاهون|ٻاھون
ٻاونجاهه|ٻاونجاھ
ٻاونجاهون|ٻاونجاھون
ٻاونجاهي|ٻاونجاھي
ٻاويهه|ٻاويھہ
ٻپهر|ٻپھر
ٻپهرو|ٻپھرو
ٻپهري|ٻپھري
ٻپوهار|ٻپوھار
ٻٽيهه|ٻٽيھہ
ٻٽيهو|ٻٽيھو
ٻٽيهي|ٻٽيھي
ٻجهڻو|ٻجهڻو
ٻجهه|ٻجهہ
ٻجهي|ٻجهي
ٻجھاء|ٻجهاء
ٻجھائڻ|ٻجهائڻ
ٻجھارت|ٻجهارت
ٻجھان|ٻجهان
ٻجھاڻ|ٻجهاڻ
ٻجھڙڪ|ٻجهڙڪ
ٻجھڪي|ٻجهڪي
ٻجھل|ٻجهل
ٻجھڻ|ٻجهڻ
ٻجھڻھار|ٻجهڻھار
ٻچڙهه|ٻچڙھہ
ٻرانگهڻ|ٻرانگهڻ
ٻرانگهه|ٻرانگهہ
ٻرانگهون|ٻرانگهون
ٻراهي|ٻراھي
ٻرگهه|ٻرگهہ
ٻرنجهه|ٻرنجهہ
ٻرنهه|ٻرنهہ
ٻرهائي|ٻرھائي
ٻرهاڙو|ٻرھاڙو
ٻرهاڙي|ٻرھاڙي
ٻرهال|ٻرھال
ٻرهام|ٻرھام
ٻرهانگ|ٻرھانگ
ٻرهانگو|ٻرھانگو
ٻرهاڻ|ٻرھاڻ
ٻرهڙو|ٻرھڙو
ٻرهل|ٻرھل
ٻرهلي|ٻرھلي
ٻرهي|ٻرھي
ٻروچاڙهڻ|ٻروچاڙھڻ
ٻروهڙ|ٻروھڙ
ٻڙگھل|ٻڙگهل
ٻڙها|ٻڙھا
ٻڙهائڻ|ٻڙھائڻ
ٻڙهڪ|ٻڙھڪ
ٻڙهڪائڻ|ٻڙھڪائڻ
ٻڙهڪڻ|ٻڙھڪڻ
ٻڙهڪو|ٻڙھڪو
ٻڙهڻ|ٻڙھڻ
ٻڙهه|ٻڙھہ
ٻڙهو|ٻڙھو
ٻڙهي|ٻڙھي
ٻڙهيا|ٻڙھيا
ٻڙهيڪو|ٻڙھيڪو
ٻڙهيون|ٻڙھيون
ٻگهرو|ٻگهرو
ٻگھئي|ٻگهئي
ٻگھارو|ٻگهارو
ٻگھاڻي|ٻگهاڻي
ٻگھلو|ٻگهلو
ٻگھه|ٻگھہ
ٻگھھ|ٻگهہ
ٻگھو|ٻگهو
ٻگھي|ٻگهي
ٻگھيا|ٻگهيا
ٻگھيرو|ٻگهيرو
ٻگھيڙو|ٻگهيڙو
ٻلانگھھ|ٻلانگهہ
ٻلانگھوڙ|ٻلانگهوڙ
ٻلھاٻاڙي|ٻلهاٻاڙي
ٻلھار|ٻلهار
ٻلھاري|ٻلهاري
ٻلھاڙو|ٻلهاڙو
ٻلھاڙي|ٻلهاڙي
ٻلھانگو|ٻلهانگو
ٻلھاڻي|ٻلهاڻي
ٻلھر|ٻلهر
ٻلھڙ|ٻلهڙ
ٻلھڙا|ٻلهڙا
ٻلھڙو|ٻلهڙو
ٻلھڪ|ٻلهڪ
ٻلھڪار|ٻلهڪار
ٻلھڪڻ|ٻلهڪڻ
ٻلھڻ|ٻلهڻ
ٻلھڻي|ٻلهڻي
ٻلھه|ٻلهہ
ٻلھو|ٻلهو
ٻلھي|ٻلهي
ٻلھياري|ٻلهياري
ٻلھيد|ٻلهيد
ٻلھيدو|ٻلهيدو
ٻنگھڻو|ٻنگهڻو
ٻنگھه|ٻنگهہ
ٻنهان|ٻنهان
ٻنهنپار|ٻنھنپار
ٻنھي|ٻنهي
ٻنھين|ٻنهين
ٻنھيون|ٻنهيون
ٻه|ٻہ
ٻهار|ٻھار
ٻهارا|ٻھارا
ٻهارائڻ|ٻھارائڻ
ٻهاراڻي|ٻھاراڻي
ٻهارڙي|ٻھارڙي
ٻهارڻ|ٻھارڻ
ٻهارڻي|ٻھارڻي
ٻهارو|ٻھارو
ٻهاري|ٻھاري
ٻهاريدار|ٻھاريدار
ٻهاڙ|ٻھاڙ
ٻهاڻ|ٻھاڻ
ٻهاڻا|ٻھاڻا
ٻهاڻو|ٻھاڻو
ٻهٻاٽ|ٻھٻاٽ
ٻهٻاٽو|ٻھٻاٽو
ٻهتر|ٻھتر
ٻهترجڻ|ٻھترجڻ
ٻهترجي|ٻھترجي
ٻهترڻ|ٻھترڻ
ٻهتريو|ٻھتريو
ٻهڃراء|ٻھڃراء
ٻهڄاڻ|ٻھڄاڻ
ٻهڄاڻا|ٻھڄاڻا
ٻهڄاڻو|ٻھڄاڻو
ٻهڊمي|ٻھڊمي
ٻهر|ٻھر
ٻهرئن|ٻھرئن
ٻهرا|ٻھرا
ٻهرائون|ٻھرائون
ٻهرائي|ٻھرائي
ٻهراري|ٻھراري
ٻهراڙي|ٻھراڙي
ٻهرال|ٻھرال
ٻهرالي|ٻھرالي
ٻهران|ٻھران
ٻهرانئون|ٻھرانئون
ٻهرانهون|ٻھرانهون
ٻهراڻو|ٻھراڻو
ٻهرپيرو|ٻھرپيرو
ٻهرتانهون|ٻھرتانهون
ٻهرتو|ٻھرتو
ٻهرمکي|ٻھرمکي
ٻهرو|ٻھرو
ٻهروپ|ٻھروپ
ٻهروپي|ٻھروپي
ٻهروپيا|ٻھروپيا
ٻهروپيو|ٻھروپيو
ٻهروٽيو|ٻھروٽيو
ٻهرون|ٻھرون
ٻهريان|ٻھريان
ٻهريتو|ٻھريتو
ٻهرين|ٻھرين
ٻهريون|ٻھريون
ٻهڙ|ٻھڙ
ٻهڙو|ٻھڙو
ٻهڦور|ٻھڦور
ٻهڪ|ٻھڪ
ٻهڪار|ٻھڪار
ٻهڪڻ|ٻھڪڻ
ٻهڪڻو|ٻھڪڻو
ٻهڪو|ٻھڪو
ٻهڳڻ|ٻھڳڻ
ٻهڳڻو|ٻھڳڻو
ٻهل|ٻھل
ٻهلڙ|ٻھلڙ
ٻهلڻ|ٻھلڻ
ٻهنڊ|ٻھنڊ
ٻهنرکي|ٻھنرکي
ٻهڻ|ٻھڻ
ٻهڻون|ٻھڻون
ٻهڻي|ٻھڻي
ٻهڻيون|ٻھڻيون
ٻهه|ٻھه
ٻهو|ٻھو
ٻهوئا|ٻھوئا
ٻهوئو|ٻھوئو
ٻهوتارا|ٻھوتارا
ٻهوڙڻ|ٻھوڙڻ
ٻهون|ٻھون
ٻهي|ٻھي
ٻهيڙا|ٻھيڙا
ٻهيڙو|ٻھيڙو
ٻھ|ٻہ
ٻھھ|ٻھہ
ٻوانجھرا|ٻوانجهرا
ٻوانجھرو|ٻوانجهرو
ٻوجھھ|ٻوجهہ
ٻوجھو|ٻوجهو
ٻوجھي|ٻوجهي
ٻوراھھ|ٻوراھ
ٻورهاڙو|ٻورھاڙو
ٻوڙاه|ٻوڙاھ
ٻوڙاهه|ٻوڙاھ
ٻوڙهائي|ٻوڙھائي
ٻوگهه|ٻوگهہ
ٻوگھرا|ٻوگهرا
ٻوگھرو|ٻوگهرو
ٻوگھريو|ٻوگهريو
ٻوگھڙ|ٻوگهڙ
ٻوگھلاڻي|ٻوگهلاڻي
ٻوگھلو|ٻوگهلو
ٻوگھو|ٻوگهو
ٻوگھي|ٻوگهي
ٻولاهو|ٻولاھو
ٻولاهي|ٻولاھي
ٻولهه|ٻولهہ
ٻولھائي|ٻولهائي
ٻولھاڙي|ٻولهاڙي
ٻولھڙ|ٻولهڙ
ٻولھيارو|ٻولهيارو
ٻوهاڙ|ٻوھاڙ
ٻوهان|ٻوھان
ٻوهٿ|ٻوھٿ
ٻوهر|ٻوھر
ٻوهڙ|ٻوھڙ
ٻوهڪي|ٻوھڪي
ٻوهل|ٻوھل
ٻوهنڊ|ٻوھنڊ
ٻوهنگرا|ٻوھنگرا
ٻوهنگرو|ٻوھنگرو
ٻوهڻي|ٻوھڻي
ٻوهه|ٻوھه
ٻوهو|ٻوھو
ٻوهي|ٻوھي
ٻوهيا|ٻوھيا
ٻوهيڙ|ٻوھيڙ
ٻوهيون|ٻوھيون
ٻيانگهه|ٻيانگهه
ٻيٻاهو|ٻيٻاھو
ٻيجاهو|ٻيجاھو
ٻيجاهي|ٻيجاھي
ٻيجهر|ٻيجهر
ٻيجهڙ|ٻيجهڙ
ٻيجهڙو|ٻيجهڙو
ٻيجهو|ٻيجهو
ٻيڪهه|ٻيڪھہ
ٻيگهڙو|ٻيگهڙو
ٻيگهو|ٻيگهو
ٻيگهي|ٻيگهي
ٻيلانگهه|ٻيلانگهہ
ٻيلنگھھ|ٻيلنگهہ
ٻيلهه|ٻيلهہ
ٻيلهون|ٻيلهون
ٻيلھار|ٻيلهار
ٻيلھاڙ|ٻيلهاڙ
ٻيلھاڙو|ٻيلهاڙو
ٻيلھاڙي|ٻيلهاڙي
ٻيلھڙ|ٻيلهڙ
ٻيلھڙو|ٻيلهڙو
ٻيلھنگ|ٻيلهنگ
ٻيلھڻ|ٻيلهڻ
ٻيلھه|ٻيلهہ
ٻيهار|ٻيھار
ٻيهاڻو|ٻيھاڻو
ٻيهر|ٻيھر
ٻيهڻ|ٻيھڻ
ٻيهڻو|ٻيھڻو
ٻيهه|ٻيھہ
پئانهين|پئانھين
پائگاهه|پائگاھ
پائنده|پائندہ
پاٻهه|پاٻھہ
پاٻهيو|پاٻھيو
پاٻوه|پاٻوہ
پاٻوهجڻ|پاٻوھجڻ
پاٻوهڻ|پاٻوھڻ
پاٻوهه|پاٻوھہ
پاٻوهي|پاٻوھي
پاتاهو|پاتاھو
پاتشاهه|پاتشاھ
پاتشاهي|پاتشاھي
پاڄاهو|پاڄاھو
پاڇاهه|پاڇاھ
پاڇاهي|پاڇاھي
پاڇوهو|پاڇوھو
پادشاهت|پادشاھت
پادشاهه|پادشاھ
پادشاهي|پادشاھي
پاڏنهن|پاڏنھن
پاڏهن|پاڏھن
پاراهي|پاراھي
پارچه|پارچہ
پاره|پارہ
پارهه|پارھہ
پارهيڙي|پارھيڙي
پارياهو|پارياھو
پارينه|پارينہ
پاريهرو|پاريھرو
پاريهل|پاريھل
پاڙها|پاڙھا
پاڙهڻ|پاڙھڻ
پاڙهڻي|پاڙھڻي
پاڙهو|پاڙھو
پاڙهيٽو|پاڙھيٽو
پاڙهيري|پاڙھيري
پاشڪسته|پاشڪستہ
پاشويه|پاشويہ
پاڪيزه|پاڪيزہ
پاگهو|پاگهو
پاڳهه|پاڳهہ
پالڻهار|پالڻھار
پالھائي|پالهائي
پالھارڻ|پالهارڻ
پالھڻپور|پالهڻپور
پالھو|پالهو
پانجاهو|پانجاھو
پانجھيرو|پانجهيرو
پانهنجو|پانھنجو
پانهون|پانھون
پانهيرو|پانھيرو
پانهين|پانھين
پاڻھي|پاڻهي
پاڻھين|پاڻهين
پاڻيهاري|پاڻيھاري
پاهان|پاھان
پاهت|پاھت
پاهرو|پاھرو
پاهڙ|پاھڙ
پاهڙي|پاھڙي
پاهڻ|پاھڻ
پاهه|پاھ
پاهو|پاھو
پاهوٽڻ|پاھوٽڻ
پاهورو|پاھورو
پاهوري|پاھوري
پاهوڙو|پاھوڙو
پاهون|پاھون
پاهي|پاھي
پاهيڙي|پاھيڙي
پاهين|پاھين
پاھھ|پاھہ
پايگاهه|پايگاھہ
پايه|پايہ
پپوهل|پپوھل
پپيهل|پپيھل
پتشاهه|پتشاھ
پٽاهڙ|پٽاھڙ
پٽهاڙ|پٽھاڙ
پٽهرو|پٽھرو
پٽهري|پٽھري
پٽهڙ|پٽھڙ
پٽهڙو|پٽھڙو
پٽهڙي|پٽھڙي
پٽهڙيون|پٽھڙيون
پٽهلو|پٽھلو
پٽهه|پٽھہ
پٽهو|پٽھو
پٽهي|پٽھي
پٽيهر|پٽيھر
پٽيهريون|پٽيھريون
پٽيهل|پٽيھل
پخته|پختہ
پدرانه|پدرانه
پدرهون|پدرھون
پڌرچڙهيو|پڌرچڙھيو
پراگنده|پراگندہ
پرانهه|پرانھہ
پرانهون|پرانھون
پرانهين|پرانھين
پراهڻ|پراھڻ
پراهون|پراھون
پرجهائڻ|پرجهائڻ
پرجهاڻي|پرجهاڻي
پرجهل|پرجهل
پرجهه|پرجهہ
پرچهه|پرچهہ
پرده|پردہ
پرڏيهه|پرڏيھہ
پرڏيهي|پرڏيھي
پرڏيھھ|پرڏيھہ
پرگهار|پرگهار
پرگهٽ|پرگهٽ
پرگهٽائڻ|پرگهٽائڻ
پرگهٽجڻ|پرگهٽجڻ
پرگهٽڻ|پرگهٽڻ
پرگهور|پرگهور
پرنده|پرندہ
پرنهڪو|پرنھڪو
پرنهن|پرنھن
پرهائڻ|پرھائڻ
پرهار|پرھار
پرهاڙو|پرھاڙو
پرهاڻي|پرھاڻي
پرهماڻي|پرھماڻي
پرهڻ|پرھڻ
پرهه|پرھہ
پرهو|پرھو
پرهوڙ|پرھوڙ
پرهوڙيو|پرھوڙيو
پرهول|پرھول
پرهولي|پرھولي
پرهيار|پرھيار
پرهيارڪي|پرھيارڪي
پرهياڙ|پرھياڙ
پرهياڻي|پرھياڻي
پرهيز|پرھيز
پرهيزگاري|پرھيزگاري
پرهيزي|پرھيزي
پرھھ|پرھہ
پروانه|پروانہ
پرواه|پرواھ
پرواهڪ|پرواھڪ
پرواهه|پرواھ
پروجھڻ|پروجهڻ
پروهت|پروھت
پرينهن|پرينھن
پرينهه|پرينھہ
پريهن|پريھن
پريهه|پريھہ
پڙنگهي|پڙنگهي
پڙهائڻ|پڙھائڻ
پڙهائي|پڙھائي
پڙهاڏو|پڙھاڏو
پڙهت|پڙھت
پڙهڻ|پڙھڻ
پڙهڻڻ|پڙھڻڻ
پڙهڻي|پڙھڻي
پڙهو|پڙھو
پڙهوڏو|پڙھوڏو
پڙهي|پڙھي
پڙهيا|پڙھيا
پڙهيار|پڙھيار
پڙهيارو|پڙھيارو
پڙهيل|پڙھيل
پڙهيوارو|پڙھيوارو
پساهه|پساھ
پسمانده|پسماندہ
پسنديده|پسنديدہ
پشتاره|پشتارہ
پگھار|پگهار
پگھارو|پگهارو
پگھاري|پگهاري
پگھر|پگهر
پڳهه|پڳھہ
پلئه|پلئہ
پلاهه|پلاھ
پلشاهي|پلشاھي
پلھا|پلها
پلھار|پلهار
پلھاڻو|پلهاڻو
پلھر|پلهر
پلھن|پلهن
پلھه|پلهہ
پلوهڻ|پلوھڻ
پناه|پناھ
پناهگير|پناھگير
پناهه|پناھ
پنبه|پنبہ
پنبهه|پنبھہ
پنبهي|پنبھي
پنبهيون|پنبھيون
پنجئه|پنجئه
پنجاسيهون|پنجاسيھون
پنجاهه|پنجاھ
پنجاهون|پنجاھون
پنجاهي|پنجاھي
پنجپايه|پنجپايہ
پنجٽيهه|پنجٽيھہ
پنجٽيهون|پنجٽيھون
پنجهتر|پنجھتر
پنجهتريون|پنجھتريون
پنجهٺ|پنجھٺ
پنجهٺيون|پنجھٺيون
پنجونجاهه|پنجونجاھ
پنجويهه|پنجويھھ
پنجويهون|پنجويھون
پنجيتاليهه|پنجيتاليھہ
پنجيتاليهون|پنجيتاليھون
پندرهن|پندرھن
پنڊپاهڻ|پنڊپاھڻ
پنڌرهن|پنڌرھن
پنرهه|پنرھہ
پنگهه|پنگهہ
پنگھون|پنگهون
پنها|پنھا
پنهچرڻ|پنھچرڻ
پنهنجا|پنھنجا
پنهنجائت|پنھنجائت
پنهنجو|پنھنجو
پنهنجون|پنھنجون
پنهنجي|پنھنجي
پنهنوار|پنھنوار
پنهنواري|پنھنواري
پنهنورڪي|پنھنورڪي
پنهوار|پنھوار
پنهوارو|پنھوارو
پنهواري|پنھواري
پنهور|پنھور
پنهون|پنھون
پنهير|پنھير
پنهيرو|پنھيرو
پنهيڙا|پنھيڙا
پنهيڙو|پنھيڙو
پنوهار|پنوھار
پنوهر|پنوھر
پنوهرڪي|پنوھرڪي
پنيگهه|پنيگهہ
پنيهر|پنيھر
پڻگھٽ|پڻگهٽ
پڻهارو|پڻھارو
پڻهاري|پڻھاري
پڻهاريون|پڻھاريون
په|پہ
پها|پھا
پهائڻ|پھائڻ
پهائي|پھائي
پهاٽ|پھاٽ
پهاج|پھاج
پهاجپو|پھاجپو
پهاڄ|پھاڄ
پهاڄپو|پھاڄپو
پهاڄڙي|پھاڄڙي
پهاڏ|پھاڏ
پهار|پھار
پهارڻ|پھارڻ
پهاڙ|پھاڙ
پهاڙن|پھاڙن
پهاڙي|پھاڙي
پهاڪو|پھاڪو
پهاڳ|پھاڳ
پهال|پھال
پهانئون|پھانئون
پهاڻ|پھاڻ
پهاڻي|پھاڻي
پهڀائڻ|پھڀائڻ
پهت|پھت
پهتڙي|پھتڙي
پهتل|پھتل
پهٽڻ|پھٽڻ
پهج|پھج
پهڄ|پھڄ
پهڄپڻو|پھڄپڻو
پهڄپو|پھڄپو
پهڄڻ|پھڄڻ
پهچ|پھچ
پهچائڻ|پھچائڻ
پهچائي|پھچائي
پهچاري|پھچاري
پهچڻ|پھچڻ
پهچوان|پھچوان
پهچي|پھچي
پهر|پھر
پهرائڻ|پھرائڻ
پهرائين|پھرائين
پهرات|پھرات
پهراز|پھراز
پهراڻ|پھراڻ
پهرجڻ|پھرجڻ
پهرڻ|پھرڻ
پهرو|پھرو
پهروٺو|پھروٺو
پهرون|پھرون
پهري|پھري
پهريء|پھريء
پهريائت|پھريائت
پهريائين|پھريائين
پهريات|پھريات
پهريٺي|پھريٺي
پهريدار|پھريدار
پهرين|پھرين
پهريندي|پھريندي
پهريون|پھريون
پهڙائڻ|پھڙائڻ
پهڙجڻ|پھڙجڻ
پهڙڻ|پھڙڻ
پهس|پھس
پهڪار|پھڪار
پهڳ|پھڳ
پهل|پھل
پهلار|پھلار
پهلر|پھلر
پهلو|پھلو
پهلوان|پھلوان
پهلوانو|پھلوانو
پهلواني|پھلواني
پهلوتهي|پھلوتھي
پهلومل|پھلومل
پهمڪ|پھمڪ
پهموندو|پھموندو
پهن|پھن
پهنائي|پھنائي
پهنچي|پھنچي
پهنڻ|پھنڻ
پهنوار|پھنوار
پهنوارجڻ|پھنوارجڻ
پهنور|پھنور
پهڻ|پھڻ
پهڻي|پھڻي
پهڻيار|پھڻيار
پهڻيرو|پھڻيرو
پهه|پھہ
پهو|پھو
پهوجا|پھوجا
پهور|پھور
پهوڙ|پھوڙ
پهوڙڻ|پھوڙڻ
پهوڙو|پھوڙو
پهوڙي|پھوڙي
پهون|پھون
پهي|پھي
پهياج|پھياج
پهياڄ|پھياڄ
پهير|پھير
پهيڙو|پھيڙو
پهينگ|پھينگ
پوئيتانهون|پوئيتانھون
پوٽه|پوٽہ
پودينه|پودينہ
پورهيت|پورھيت
پورهيتي|پورھيتي
پورهيو|پورھيو
پوڙهائي|پوڙھائي
پوڙهو|پوڙهو
پوگهه|پوگهہ
پولهه|پولهہ
پونجهه|پونجهہ
پونجھا|پونجها
پونجھو|پونجهو
پوهائي|پوھائي
پوهانئون|پوھانئون
پوهه|پوهہ
پوهَه|پوهَہ
پوهو|پوھو
پوهيتاڻي|پوھيتاڻي
پياده|پيادہ
پياله|پيالہ
پيٽهڙو|پيٽھڙو
پيڄاهو|پيڄاھو
پيچوها|پيچوھا
پيچوهو|پيچوھو
پيچيده|پيچيدہ
پيراسته|پيراستہ
پيرانه|پيرانه
پيراهن|پيراھن
پيرايه|پيرايہ
پيرهن|پيرھن
پيرهيات|پيرھيات
پيڙهڻ|پيڙھڻ
پيڙهه|پيڙھہ
پيڙهو|پيڙھو
پيڙهي|پيڙھي
پيڙهيء|پيڙھيء
پيڙهيات|پيڙھيات
پيڙهيارو|پيڙھيارو
پيڙهيو|پيڙھيو
پيڙهيون|پيڙھيون
پيشه|پيشہ
پيڪارهه|پيڪارھہ
پيلانجھو|پيلانجهو
پيلانگھو|پيلانگهو
پينجھوڙي|پينجهوڙي
پينگهه|پينگهہ
پينگھارو|پينگهارو
پينگھاڙو|پينگهاڙو
پينگھه|پينگھہ
پينگھو|پينگهو
پينگھون|پينگهون
پينگھي|پينگهي
پيهائڻ|پيھائڻ
پيهائي|پيھائي
پيهاٽ|پيھاٽ
پيهان|پيھان
پيهاڻي|پيھاڻي
پيهٽ|پيهٽ
پيهجڻ|پيهجڻ
پيهر|پيھر
پيهريون|پيھريون
پيهڙ|پيھڙ
پيهڙو|پيھڙو
پيهڪ|پيھڪ
پيهلو|پيھلو
پيهم|پيھم
پيهڻ|پيھڻ
پيهڻي|پيھڻي
پيهه|پيھہ
پيهو|پيھو
پيهوڙي|پيھوڙي
پيهون|پيھون
پيهي|پيھي
پيوسته|پيوستہ
ڀئه|ڀئہ
ڀاڳڏيهه|ڀاڳڏيھہ
ڀانگها|ڀانگها
ڀانگهو|ڀانگهو
ڀجهرو|ڀجهرو
ڀرجهر|ڀرجهر
ڀرجهڙ|ڀرجهڙ
ڀرجهلو|ڀرجهلو
ڀرڳڙهه|ڀرڳڙھہ
ڀره|ڀرہ
ڀنجهر|ڀنجهر
ڀنجهه|ڀنجهہ
ڀنجهو|ڀنجهو
ڀنگوجهڻ|ڀنگوجهڻ
ڀنوارهون|ڀنوارھون
ڀوڳهڙو|ڀوڳھڙو
ڀوهر|ڀوھر
ڀيلهڙ|ڀيلهڙ
ڀيڻهان|ڀيڻھان
تئه|تئہ
تابنده|تابندہ
تابه|تابہ
تاٿانهون|تاٿانھون
تاٿهين|تاٿھين
تاڏانهين|تاڏانھين
تاڏنهن|تاڏنھن
تاڏهان|تاڏھان
تاڏهون|تاڏهون
تاڏهين|تاڏهين
تارالاهڻ|تارالاھڻ
تاراهه|تاراھ
تارڻهار|تارڻھار
تازه|تازہ
تاگھاتو|تاگهاتو
تالھڙو|تالهڙو
تانگهه|تانگهہ
تانگھائڻ|تانگهائڻ
تانگھائي|تانگهائي
تانگھڻ|تانگهڻ
تانگھو|تانگهو
تانگھي|تانگهي
تانهري|تانھري
تانهون|تانھون
تانهوڻ|تانھوڻ
تاهري|تاھري
تاهڻو|تاھڻو
تاهو|تاھو
تاهوت|تاھوت
تبادله|تبادلہ
تباهه|تباھ
تباهي|تباھي
تبخاله|تبخالہ
تٿانهون|تٿانھون
تجاهل|تجاھل
تجهيز|تجھيز
تحريمه|تحريمہ
تختگاهه|تختگاھ
تڏهانڪر|تڏھانڪر
تڏهانڪو|تڏھانڪو
تڏهن|تڏھن
تڏهوڪو|تڏھوڪو
تڏهوڻڪو|تڏھوڻڪو
تڏهوڻو|تڏھوڻو
تڏهين|تڏھين
ترانگھڙو|ترانگهڙو
تراهه|تراھ
تراهي|تراھي
ترڳاهه|ترڳاھ
ترهاٽ|ترھاٽ
ترهاٽجڻ|ترھاٽجڻ
ترهٽ|ترھٽ
ترهٽجڻ|ترھٽجڻ
ترهٽي|ترھٽي
ترهو|ترھو
ترهوٽ|ترھوٽ
ترينهن|ترينھن
تزڪيه|تزڪيہ
تساهل|تساھل
تست|تست
تسهيل|تسھيل
تشابهه|تشابھہ
تشبيهه|تشبيھہ
تشبيهي|تشبيھي
تشنه|تشنہ
تشهير|تشھير
تطهير|تطھير
تفضيليه|تفضيليہ
تفهيم|تفھيم
تڪيه|تڪيہ
تلاهه|تلاھ
تلاهي|تلاھي
تلهائي|تلھائي
تلهار|تلھار
تلهاڻي|تلھاڻي
تلهر|تلھر
تلهڙ|تلھڙ
تلهه|تلھہ
تلهو|تلھو
تلهي|تلھي
تلھيٽو|تلهيٽو
تلھيدار|تلهيدار
تلھيرو|تلهيرو
تليهر|تليھر
تماشگاه|تماشگاہ
تمهارو|تمھارو
تمهيد|تمھيد
تنبيهه|تنبيھہ
تنخواه|تنخواہ
تنخواهه|تنخواھ
تنزيهه|تنزيھہ
تنگهه|تنگهہ
تنگھياڻي|تنگهياڻي
تنها|تنھا
تنهائي|تنھائي
تنهن|تنھن
تنهنجا|تنھنجا
تنهنجو|تنھنجو
تنهنجي|تنھنجي
تنهنڪري|تنھنڪري
تنهين|تنھين
ته|تہ
تهؤن|تھؤن
تهائتو|تھائتو
تهائڻ|تھائڻ
تهائو|تھائو
تهائين|تھائين
تهار|تھار
تهارن|تھارن
تهارڻ|تھارڻ
تهارڻيون|تھارڻيون
تهارون|تھارون
تهاڙو|تھاڙو
تهبارون|تھبارون
تهبان|تھبان
تهبند|تھبند
تهت|تھت
تهتئون|تھتئون
تهتا|تھتا
تهتڙا|تھتڙا
تهجد|تھجد
تهجي|تھجي
تهجّي|تھجّي
تهخانو|تھخانو
تهدر|تھدر
تهدل|تھدل
تهديد|تھديد
تهذيب|تھذيب
تهر|تھر
تهري|تھري
تهڙ|تھڙ
تهڙا|تھڙا
تهڙو|تھڙو
تهسب|تھسب
تهسبو|تھسبو
تهطلب|تھطلب
تهڪارڻ|تھڪارڻ
تهل|تھل
تهلڪ|تھلڪ
تهلڪو|تھلڪو
تهمت|تھمت
تهمتي|تھمتي
تهمل|تھمل
تهموري|تھموري
تهن|تھن
تهنال|تھنال
تهنبل|تھنبل
تهنيت|تھنيت
تهه|تھه
تهو|تھو
تهوارون|تھوارون
تهوت|تھوت
تهور|تھور
تهي|تھي
تهياري|تھياري
تهيپو|تھيپو
تهيت|تھيت
تهير|تھير
تهيري|تھيري
تهين|تھين
تهيه|تھيہ
تهيون|تھيون
تھ|تہ
توبه|توبہ
توبهه|توبھہ
توجه|توجہ
توجهي|توجھي
توجيه|توجيہ
توچڻاه|توچڻاھ
تودهه|تودھہ
توشه|توشہ
تونهين|تونھين
توهائڻ|توھائڻ
توهار|توھار
توهان|توھان
توهر|توھر
توهڙ|توھڙ
توهڻ|توھڻ
توهه|توھہ
توهيا|توھيا
توهين|توھين
تيڏانهن|تيڏانھن
تيڏانهون|تيڏانھون
تيڏانهين|تيڏانھين
تيربهدف|تيربھدف
تيره|تيرہ
تيرهن|تيرھن
تيرهو|تيرھو
تيرهون|تيرھون
تيرهي|تيرھي
تيرهيو|تيرھيو
تيلاهو|تيلاھو
تيلاهين|تيلاھين
تيلهه|تيلهہ
تيلھان|تيلهان
تيلھوڙي|تيلهوڙي
تيلھوڙيون|تيلهوڙيون
تيهارڻ|تيھارڻ
تيهو|تيھو
ثابته|ثابتہ
ثانيه|ثانيہ
ثقه|ثقہ
ثلاثه|ثلاثہ
ثمره|ثمرہ
ثيبه|ثيبہ
ٺاٺوهڻ|ٺاٺوھڻ
ٺالهه|ٺالهہ
ٺالھجڻ|ٺالهجڻ
ٺالھجي|ٺالهجي
ٺالھڻ|ٺالهڻ
ٺالھو|ٺالهو
ٺالھي|ٺالهي
ٺانگاهه|ٺانگاھ
ٺاهري|ٺاھري
ٺاهڻ|ٺاھڻ
ٺاهه|ٺاھ
ٺاههِ|ٺاهہِ
ٺاهو|ٺاھو
ٺاهوڪو|ٺاھوڪو
ٺاهي|ٺاھي
ٺٽه|ٺٽہ
ٺرهار|ٺرھار
ٺڙهه|ٺڙھہ
ٺلاهه|ٺلاھ
ٺلهه|ٺلهہ
ٺلھا|ٺلها
ٺلھائي|ٺلهائي
ٺلھڻ|ٺلهڻ
ٺلھو|ٺلهو
ٺلھي|ٺلهي
ٺهاء|ٺھاء
ٺهائتو|ٺھائتو
ٺهائڻ|ٺھائڻ
ٺهپ|ٺھپ
ٺهپر|ٺھپر
ٺهت|ٺھت
ٺهٺپ|ٺھٺپ
ٺهٽ|ٺھٽ
ٺهر|ٺھر
ٺهراء|ٺھراء
ٺهرائتو|ٺھرائتو
ٺهرائڻ|ٺھرائڻ
ٺهرڻ|ٺھرڻ
ٺهرو|ٺھرو
ٺهري|ٺھري
ٺهريل|ٺھريل
ٺهڦهه|ٺھڦھہ
ٺهڪائڻ|ٺھڪائڻ
ٺهڪڻ|ٺھڪڻ
ٺهڪڻو|ٺھڪڻو
ٺهڪو|ٺھڪو
ٺهڪي|ٺھڪي
ٺهندو|ٺھندو
ٺهندي|ٺھندي
ٺهنڪار|ٺھنڪار
ٺهنگو|ٺھنگو
ٺهڻ|ٺھڻ
ٺهه|ٺھہ
ٺهو|ٺھو
ٺهوڙ|ٺھوڙ
ٺهوڙڻ|ٺھوڙڻ
ٺهي|ٺھي
ٺهيل|ٺھيل
ٺوڙها|ٺوڙھا
ٺوڙهه|ٺوڙھہ
ٺوڙهو|ٺوڙھو
ٺوڙهي|ٺوڙھي
ٺوڙهيء|ٺوڙھيء
ٺوڙهيون|ٺوڙھيون
ٺولھڙو|ٺولهڙو
ٺولھڻو|ٺولهڻو
ٺولھو|ٺولهو
ٺولھي|ٺولهي
ٺونهڻ|ٺونھڻ
ٺوه|ٺوہ
ٺوهڻ|ٺوھڻ
ٺوهيو|ٺوھيو
ٺيڙهي|ٺيڙهي
ٺيلهه|ٺيلهہ
ٺيلھائڻ|ٺيلهائڻ
ٺيلھان|ٺيلهان
ٺيلھجڻ|ٺيلهجڻ
ٺيلھڻ|ٺيلهڻ
ٺيلھو|ٺيلهو
ٺيلھي|ٺيلهي
ٺينهون|ٺينھون
ٺيهه|ٺيھہ
ٺيهو|ٺيھو
ٽاڙهه|ٽاڙھہ
ٽاڙهو|ٽاڙھو
ٽاڙهي|ٽاڙھي
ٽالهه|ٽالهہ
ٽالھڻ|ٽالهڻ
ٽالھو|ٽالهو
ٽالھي|ٽالهي
ٽالھياري|ٽالهياري
ٽاهڙ|ٽاھڙ
ٽاهڻ|ٽاھڻ
ٽاهه|ٽاھ
ٽاهو|ٽاھو
ٽاهوڪ|ٽاھوڪ
ٽٻوهي|ٽٻوھي
ٽپهري|ٽپھري
ٽٽيهر|ٽٽيھر
ٽجهڻ|ٽجهڻ
ٽرهائجڻ|ٽرھائجڻ
ٽرهائڻ|ٽرھائڻ
ٽرهاڙ|ٽرھاڙ
ٽرهاڙي|ٽرھاڙي
ٽرهاڙيون|ٽرھاڙيون
ٽرهاڻا|ٽرھاڻا
ٽرهڙ|ٽرھڙ
ٽرهڻ|ٽرھڻ
ٽرهه|ٽرھہ
ٽرهوڙ|ٽرھوڙ
ٽريلڙهه|ٽريلڙھہ
ٽريلھڙ|ٽريلهڙ
ٽريلھه|ٽريلهہ
ٽريها|ٽريھا
ٽريهان|ٽريھان
ٽريهتر|ٽريھتر
ٽريهٺ|ٽريھٺ
ٽريهر|ٽريھر
ٽريهڙ|ٽريھڙ
ٽريهن|ٽريھن
ٽريهڻ|ٽريھڻ
ٽريهه|ٽريھہ
ٽريهو|ٽريھو
ٽريهون|ٽريھون
ٽريونجاه|ٽريونجاھ
ٽڙهه|ٽڙھہ
ٽڙهو|ٽڙھو
ٽگھڙو|ٽگهڙو
ٽگھلجڻ|ٽگهلجڻ
ٽلڙهه|ٽلڙھہ
ٽلڙهو|ٽلڙھو
ٽلهه|ٽلهہ
ٽماهو|ٽماھو
ٽماهي|ٽماھي
ٽمجهڻ|ٽمجهڻ
ٽمنهون|ٽمنھون
ٽمنهين|ٽمنھين
ٽمونهين|ٽمونھين
ٽنگھڻ|ٽنگهڻ
ٽنوهر|ٽنوھر
ٽه|ٽہ
ٽهائجڻ|ٽھائجڻ
ٽهائڻ|ٽھائڻ
ٽهار|ٽھار
ٽهارڻ|ٽھارڻ
ٽهارو|ٽھارو
ٽهاڙ|ٽھاڙ
ٽهاڙي|ٽھاڙي
ٽهاڙيون|ٽھاڙيون
ٽهاڻ|ٽھاڻ
ٽهاڻا|ٽھاڻا
ٽهاڻو|ٽھاڻو
ٽهڏ|ٽھڏ
ٽهر|ٽھر
ٽهرائڻ|ٽھرائڻ
ٽهرڻ|ٽھرڻ
ٽهڙ|ٽھڙ
ٽهڙائي|ٽھڙائي
ٽهڙو|ٽھڙو
ٽهڪڻ|ٽھڪڻ
ٽهڳ|ٽھڳ
ٽهڳو|ٽھڳو
ٽهلي|ٽھلي
ٽهڻ|ٽھڻ
ٽهڻي|ٽھڻي
ٽهه|ٽھہ
ٽهو|ٽھو
ٽهوڙ|ٽھوڙ
ٽهي|ٽھي
ٽوريهو|ٽوريھو
ٽوڙهو|ٽوڙھو
ٽولھر|ٽولهر
ٽولھڙو|ٽولهڙو
ٽوها|ٽوھا
ٽوهال|ٽوھال
ٽوهڙ|ٽوھڙ
ٽوهه|ٽوھہ
ٽوهو|ٽوھو
ٽوهي|ٽوھي
ٽوهيو|ٽوھيو
ٽوهيون|ٽوھيون
ٽيانگھي|ٽيانگهي
ٽيانگھيون|ٽيانگهيون
ٽيپهري|ٽيپھري
ٽيتاليهه|ٽيتاليھہ
ٽيٽاهه|ٽيٽاھ
ٽيٽيهر|ٽيٽيھر
ٽيٽيهه|ٽيٽيھہ
ٽيجهه|ٽيجهہ
ٽيجھو|ٽيجهو
ٽيلڙهه|ٽيلڙھہ
ٽيلھڙ|ٽيلهڙ
ٽيلھه|ٽيلهہ
ٽيهئي|ٽيھئي
ٽيها|ٽيھا
ٽيهان|ٽيھان
ٽيهاڻ|ٽيھاڻ
ٽيهاڻا|ٽيھاڻا
ٽيهاڻو|ٽيھاڻو
ٽيهتر|ٽيھتر
ٽيهٺ|ٽيھٺ
ٽيهر|ٽيھر
ٽيهڙ|ٽيھڙ
ٽيهڻ|ٽيھڻ
ٽيهه|ٽيھہ
ٽيهو|ٽيھو
ٽيهون|ٽيھون
ٽيهين|ٽيھين
ٽيونجاه|ٽيونجاھ
ٿالهہ|ٿالهہ
ٿالھي|ٿالهي
ٿالھيء|ٿالهيء
ٿالھيئون|ٿالهيئون
ٿانهر|ٿانھر
ٿانهريو|ٿانھريو
ٿاهر|ٿاھر
ٿاهرڻ|ٿاھرڻ
ٿاهرو|ٿاھرو
ٿاهه|ٿاھ
ٿاهي|ٿاھي
ٿرڄاها|ٿرڄاھا
ٿرهانڊو|ٿرھانڊو
ٿڙها|ٿڙھا
ٿڙهو|ٿڙھو
ٿڙهي|ٿڙھي
ٿڙهيون|ٿڙھيون
ٿلهه|ٿلهہ
ٿلھا|ٿلها
ٿلھڙ|ٿلهڙ
ٿلھڙو|ٿلهڙو
ٿلھو|ٿلهو
ٿلھي|ٿلهي
ٿلھيرڙو|ٿلهيرڙو
ٿنهر|ٿنھر
ٿنهرائڻ|ٿنھرائڻ
ٿنهرڻ|ٿنھرڻ
ٿنهڻ|ٿنھڻ
ٿنهه|ٿنھہ
ٿنهي|ٿنھي
ٿهائتو|ٿھائتو
ٿهر|ٿھر
ٿهرائڻ|ٿھرائڻ
ٿهرم|ٿھرم
ٿهرڻ|ٿھرڻ
ٿهرو|ٿھرو
ٿهريو|ٿھريو
ٿهمر|ٿھمر
ٿهڻ|ٿھڻ
ٿهو|ٿھو
ٿهي|ٿھي
ٿهيم|ٿھيم
ٿولهه|ٿولهہ
ٿوهان|ٿوھان
ٿوهر|ٿوھر
ٿوهڙ|ٿوھڙ
ٿوهه|ٿوھہ
ٿوهو|ٿوھو
ٿيلهه|ٿيلهہ
ٿيلھا|ٿيلها
ٿيلھڻ|ٿيلهڻ
ٿيلھو|ٿيلهو
ٿيلھي|ٿيلهي
ٿيلھيء|ٿيلهيء
ٿيلھيون|ٿيلهيون
جئه|جئہ
جاٿانهون|جاٿانھون
جاجهڳڙا|جاجهڳڙا
جاجهڻجا|جاجهڻجا
جاجهه|جاجهہ
جاجهوڙڻ|جاجهوڙڻ
جاده|جادہ
جاذبه|جاذبہ
جاڏانهن|جاڏانھن
جاڏاهون|جاڏاھون
جاڏنهن|جاڏنھن
جاڏهن|جاڏھن
جاگها|جاگها
جاڳاهه|جاڳاھ
جاڳهه|جاڳھہ
جامجهان|جامجھان
جامعه|جامعہ
جامه|جامہ
جاميه|جاميہ
جانجهه|جانجهہ
جانجھر|جانجهر
جانجھرو|جانجهرو
جانجھڻ|جانجهڻ
جانجھه|جانجھہ
جانجھولڻ|جانجهولڻ
جانجھولو|جانجهولو
جانڊاه|جانڊاھ
جانڊاهي|جانڊاھي
جانڊهه|جانڊھہڱ
جانڪاه|جانڪاھ
جانهريو|جانھريو
جانهولو|جانھولو
جانهوليو|جانھوليو
جاه|جاھ
جاهل|جاھل
جاهلپڻو|جاھلپڻو
جاهلي|جاھلي
جاهليت|جاھليت
جاهه|جاھ
جبهه|جبھہ
جتاهون|جتاھون
جتنهون|جتنھون
جٽاهانسي|جٽاھانسي
جٿانهون|جٿانھون
ججهڪو|ججهڪو
ججهه|ججهہ
ججهو|ججهو
جداگانه|جداگانہ
جده|جدہ
جديده|جديدہ
جڏهاڪر|جڏھاڪر
جڏهاڪو|جڏھاڪو
جڏهانڪر|جڏھانڪر
جڏهانڪو|جڏھانڪو
جڏهن|جڏھن
جڏهوڪو|جڏھوڪو
جڏهوڻڪو|جڏھوڻڪو
جڏهوڻو|جڏھوڻو
جڏهين|جڏھين
جرعه|جرعہ
جرڪوهيارو|جرڪوھيارو
جزيه|جزيہ
جسته|جستہ
جغرافيه|جغرافيہ
جفاپيشه|جفاپيشہ
جڪٽاهه|جڪٽاھ
جڳهه|جڳھہ
جڳھه|جڳھہ
جلئه|جلئہ
جلاله|جلالہ
جلاهو|جلاھو
جلهه|جلهہ
جلھڻ|جلهڻ
جلوه|جلوہ
جمره|جمرہ
جمعه|جمعہ
جمهور|جمھور
جمهوري|جمھوري
جمهوريت|جمھوريت
جمهوريه|جمھوريہ
جنباهه|جنباھ
جنجهه|جنجهہ
جنجھڻ|جنجهڻ
جنجھڻو|جنجهڻو
جنجھي|جنجهي
جنجھير|جنجهير
جنگاهه|جنگاھ
جنگشاهي|جنگشاھي
جنهر|جنھر
جنهن|جنھن
جنهنجي|جنھنجي
جنهڻ|جنھڻ
جنهوار|جنھوار
جنهور|جنھور
جنهوري|جنھوري
جنوهار|جنوھار
جنوهر|جنوھر
جنوهردار|جنوھردار
جه|جہ
جهائو|جھائو
جهائوئو|جھائوئو
جهائـين|جھائـين
جهاجهه|جهاجهہ
جهاد|جھاد
جهاز|جھاز
جهازران|جھازران
جهازي|جھازي
جهالت|جھالت
جهان|جھان
جهانء|جھانء
جهانئون|جھانئون
جهانئين|جھانئين
جهانار|جهانار
جهانجهه|جهانجهہ
جهانجهَه|جهانجهَہ
جهانگير|جھانگير
جهانگيڙو|جهانگيڙو
جهانهليو|جهانھليو
جهجهاڻ|جهجهاڻ
جهجهه|جهجهہ
جهد|جھد
جهڏ|جهڏ
جهڙو|جھڙو
جهڙي|جھڙي
جهل|جھل
جهن|جھن
جهنبڻ|جهنبڻ
جهنم|جھنم
جهنمي|جھنمي
جهنو|جھنو
جهه|جھہ
جهو|جھو
جهينجهه|جهينجهہ
جھئڪڻ|جهئڪڻ
جھئنڪو|جهئنڪو
جھاٻ|جهاٻ
جھاٻر|جهاٻر
جھاٻو|جهاٻو
جھاٻيرو|جهاٻيرو
جھاٻيري|جهاٻيري
جھاٻيلي|جهاٻيلي
جھاپ|جهاپ
جھاپو|جهاپو
جھاپول|جهاپول
جھات|جهات
جھاتر|جهاتر
جھاتڙي|جهاتڙي
جھاتي|جهاتي
جھاتير|جهاتير
جھاتيون|جهاتيون
جھاٽ|جهاٽ
جھاٽڪو|جهاٽڪو
جھاٽڻ|جهاٽڻ
جھاٽو|جهاٽو
جھاٽي|جهاٽي
جھاجھائڻ|جهاجهائڻ
جھاجھائي|جهاجهائي
جھاجھر|جهاجهر
جھاجھم|جهاجهم
جھار|جهار
جھارا|جهارا
جھارڻ|جهارڻ
جھارو|جهارو
جھاري|جهاري
جھاڙ|جهاڙ
جھاڙکو|جهاڙکو
جھاڙڪو|جهاڙڪو
جھاڙڻ|جهاڙڻ
جھاڙو|جهاڙو
جھاڙوکيو|جهاڙوکيو
جھاڙولو|جهاڙولو
جھاڙي|جهاڙي
جھاڪ|جهاڪ
جھاڪڻ|جهاڪڻ
جھاڪو|جهاڪو
جھاڳ|جهاڳ
جھاڳڻ|جهاڳڻ
جھاڳور|جهاڳور
جھاڳورا|جهاڳورا
جھاڳورڻ|جهاڳورڻ
جھاڳوري|جهاڳوري
جھاڳوڙڻ|جهاڳوڙڻ
جھاڳي|جهاڳي
جھال|جهال
جھالا|جهالا
جھالائو|جهالائو
جھالار|جهالار
جھالارو|جهالارو
جھالاري|جهالاري
جھالر|جهالر
جھالردار|جهالردار
جھالڪو|جهالڪو
جھالو|جهالو
جھالي|جهالي
جھاليون|جهاليون
جھام|جهام
جھامٽي|جهامٽي
جھامرو|جهامرو
جھاموٽجڻ|جهاموٽجڻ
جھانپو|جهانپو
جھانپور|جھانپور
جھانڀا|جهانڀا
جھانڀو|جهانڀو
جھانٽ|جهانٽ
جھانجھر|جهانجهر
جھانجھرا|جهانجهرا
جھانجھرو|جهانجهرو
جھانجھلي|جهانجهلي
جھانجھڻجا|جهانجهڻجا
جھانجھھ|جھانجھہ
جھانڪ|جهانڪ
جھانڪڻ|جهانڪڻ
جھانڪو|جهانڪو
جھانگارا|جهانگارا
جھانگاري|جهانگاري
جھانگاڻ|جهانگاڻ
جھانگرو|جهانگرو
جھانگڙو|جهانگڙو
جھانگي|جهانگي
جھانور|جهانور
جھانورا|جهانورا
جھانورائي|جهانورائي
جھانورو|جهانورو
جھاني|جهاني
جھٻ|جهٻ
جھٻا|جهٻا
جھٻائڻ|جهٻائڻ
جھٻٽ|جهٻٽ
جھٻٽڻ|جهٻٽڻ
جھٻر|جهٻر
جھٻرڪ|جهٻرڪ
جھٻڪو|جهٻڪو
جھٻلو|جهٻلو
جھٻڻ|جهٻڻ
جھٻو|جهٻو
جھٻي|جهٻي
جھٻير|جهٻير
جھپ|جهپ
جھپائڻ|جهپائڻ
جھپاٽو|جهپاٽو
جھپامڻ|جهپامڻ
جھپٽ|جهپٽ
جھپٽي|جهپٽي
جھپجڻ|جهپجڻ
جھپر|جهپر
جھپڙ|جهپڙ
جھپڙڻ|جهپڙڻ
جھپڪو|جهپڪو
جھپلا|جهپلا
جھپڻ|جهپڻ
جھپو|جهپو
جھپيٽ|جهپيٽ
جھت|جهت
جھتر|جهتر
جھتري|جهتري
جھتي|جهتي
جھتيال|جهتيال
جھٽ|جهٽ
جھٽجڻ|جهٽجڻ
جھٽر|جهٽر
جھٽڪڻ|جهٽڪڻ
جھٽڪو|جهٽڪو
جھٽڻ|جهٽڻ
جھٽو|جهٽو
جھٽون|جهٽون
جھٽي|جهٽي
جھٽيء|جهٽيء
جھٽيال|جهٽيال
جھٽينگ|جهٽينگ
جھٽيون|جهٽيون
جھجھائي|جهجهائي
جھجھر|جهجهر
جھجھري|جهجهري
جھجھڪارڻ|جهجهڪارڻ
جھجھو|جهجهو
جھڄ|جهڄ
جھڄڻ|جهڄڻ
جھڏا|جهڏا
جھڏو|جهڏو
جھڏون|جهڏون
جھر|جهر
جھراٽ|جهراٽ
جھرانڊي|جهرانڊي
جھرجھور|جهرجهور
جھرر|جهرر
جھرڙ|جهرڙ
جھرڙڻ|جهرڙڻ
جھرڪ|جهرڪ
جھرڪلي|جهرڪلي
جھرڪڻ|جهرڪڻ
جھرڪڻو|جهرڪڻو
جھرڪڻي|جهرڪڻي
جھرڪو|جهرڪو
جھرڪي|جهرڪي
جھرڪياري|جهرڪياري
جھرڪيون|جهرڪيون
جھرڳ|جهرڳ
جھرڳل|جهرڳل
جھرمٽ|جهرمٽ
جھرمر|جهرمر
جھرڻ|جهرڻ
جھرڻو|جهرڻو
جھرو|جهرو
جھروٽ|جهروٽ
جھروڪ|جهروڪ
جھروڪو|جهروڪو
جھرون|جهرون
جھري|جهري
جھريل|جهريل
جھريندو|جهريندو
جھڙ|جهڙ
جھڙا|جهڙا
جھڙائي|جهڙائي
جھڙالو|جهڙالو
جھڙالي|جهڙالي
جھڙپ|جهڙپ
جھڙپڻ|جهڙپڻ
جھڙڪو|جهڙڪو
جھڙڳ|جهڙڳ
جھڙڳا|جهڙڳا
جھڙڳو|جهڙڳو
جھڙڻ|جهڙڻ
جھڙيارو|جهڙيارو
جھڙيل|جهڙيل
جھڙيون|جهڙيون
جھڪ|جهڪ
جھڪائجڻ|جهڪائجڻ
جھڪائڻ|جهڪائڻ
جھڪائي|جهڪائي
جھڪاٽڻ|جهڪاٽڻ
جھڪاجھڪ|جهڪاجهڪ
جھڪاڻ|جهڪاڻ
جھڪجڻ|جهڪجڻ
جھڪڪو|جهڪڪو
جھڪل|جهڪل
جھڪڻ|جهڪڻ
جھڪڻو|جهڪڻو
جھڪو|جهڪو
جھڪوٽ|جهڪوٽ
جھڪور|جهڪور
جھڪوڙڻ|جهڪوڙڻ
جھڪي|جهڪي
جھگر|جهگر
جھڳ|جهڳ
جھڳارڻ|جهڳارڻ
جھڳٽو|جهڳٽو
جھڳرو|جهڳرو
جھڳڙ|جهڳڙ
جھڳڙا|جهڳڙا
جھڳڙائي|جهڳڙائي
جھڳڙڻ|جهڳڙڻ
جھڳڙو|جهڳڙو
جھڳڙي|جهڳڙي
جھڳل|جهڳل
جھڳلي|جهڳلي
جھڳمڳ|جهڳمڳ
جھڳمڳيو|جهڳمڳيو
جھڳڻ|جهڳڻ
جھڳو|جهڳو
جھڳور|جهڳور
جھڳورڻ|جهڳورڻ
جھڳوري|جهڳوري
جھڳوڙ|جهڳوڙ
جھڳوڙڻ|جهڳوڙڻ
جھڳي|جهڳي
جھڳيا|جهڳيا
جھل|جهل
جھلائڻ|جهلائڻ
جھلائو|جهلائو
جھلجڻ|جهلجڻ
جھلري|جهلري
جھلڪ|جهلڪ
جھلڪا|جهلڪا
جھلڪار|جهلڪار
جھلڪڻ|جهلڪڻ
جھلڪڻو|جهلڪڻو
جھلڪو|جهلڪو
جھلنگ|جهلنگ
جھلڻ|جهلڻ
جھلڻو|جهلڻو
جھلو|جهلو
جھلوري|جهلوري
جھلون|جهلون
جھلي|جهلي
جھم|جهم
جھما|جهما
جھمائڻ|جهمائڻ
جھمٽ|جهمٽ
جھمٽا|جهمٽا
جھمٽڙي|جهمٽڙي
جھمٽو|جهمٽو
جھمٽي|جهمٽي
جھمر|جهمر
جھمريون|جهمريون
جھمڪ|جهمڪ
جھمڪائڻ|جهمڪائڻ
جھمڪڻ|جهمڪڻ
جھمڪو|جهمڪو
جھمڻ|جهمڻ
جھمو|جهمو
جھمي|جهمي
جھنئرو|جهنئرو
جھنئوڪو|جهنئوڪو
جھنپڻ|جهنپڻ
جھنڀوٽ|جهنڀوٽ
جھنڀوٽڻ|جهنڀوٽڻ
جھنڀوٽين|جهنڀوٽين
جھنجھٽ|جهنجهٽ
جھنجھڻ|جهنجهڻ
جھنجھڻو|جهنجهڻو
جھنجھھ|جهنجهہ
جھنجھوٽي|جهنجهوٽي
جھنجھوڙڻ|جهنجهوڙڻ
جھنجھي|جهنجهي
جھنڊ|جهنڊ
جھنڊا|جهنڊا
جھنڊائڻ|جهنڊائڻ
جھنڊاڻي|جهنڊاڻي
جھنڊجڻ|جهنڊجڻ
جھنڊڻ|جهنڊڻ
جھنڊو|جهنڊو
جھنڊولو|جهنڊولو
جھنڊي|جهنڊي
جھنگ|جهنگ
جھنگار|جهنگار
جھنگارا|جهنگارا
جھنگارڻ|جهنگارڻ
جھنگر|جهنگر
جھنگراٽو|جهنگراٽو
جھنگرار|جهنگرار
جھنگراڙ|جهنگراڙ
جھنگل|جهنگل
جھنگلپائي|جهنگلپائي
جھنگلو|جهنگلو
جھنگلي|جهنگلي
جھنگليپڻ|جهنگليپڻ
جھنگليپڻو|جهنگليپڻو
جھنگڻ|جهنگڻ
جھنگو|جهنگو
جھنوڻ|جهنوڻ
جھڻ|جهڻ
جھڻٻچو|جهڻٻچو
جھڻڪ|جهڻڪ
جھڻڪار|جهڻڪار
جھڻڪڻ|جهڻڪڻ
جھڻي|جهڻي
جھوئڻ|جهوئڻ
جھوٻ|جهوٻ
جھوٻاٽڻ|جهوٻاٽڻ
جھوٻڻ|جهوٻڻ
جھوٻو|جهوٻو
جھوٻيل|جهوٻيل
جھوپڙو|جهوپڙو
جھوپڙي|جهوپڙي
جھوت|جهوت
جھوتا|جهوتا
جھوتائي|جهوتائي
جھوتڻ|جهوتڻ
جھوتو|جهوتو
جھوتون|جهوتون
جھوٽ|جهوٽ
جھوٽا|جهوٽا
جھوٽڻ|جهوٽڻ
جھوٽو|جهوٽو
جھوجھر|جهوجهر
جھوجھو|جهوجهو
جھور|جهور
جھورا|جهورا
جھورائڻ|جهورائڻ
جھوراڻو|جهوراڻو
جھورڻ|جهورڻ
جھورو|جهورو
جھوري|جهوري
جھوڙ|جهوڙ
جھوڙڻ|جهوڙڻ
جھوڙو|جهوڙو
جھوڙي|جهوڙي
جھوڙيدار|جهوڙيدار
جھوڪ|جهوڪ
جھوڪڙ|جهوڪڙ
جھوڪڻ|جهوڪڻ
جھوڪو|جهوڪو
جھوڳ|جهوڳ
جھوڳڻ|جهوڳڻ
جھول|جهول
جھولائڻ|جهولائڻ
جھولان|جهولان
جھولڻ|جهولڻ
جھولڻو|جهولڻو
جھولو|جهولو
جھولي|جهولي
جھوليء|جهوليء
جھوم|جهوم
جھومر|جهومر
جھومڪ|جهومڪ
جھومڪو|جهومڪو
جھون|جهون
جھونا|جهونا
جھونائي|جهونائي
جھونپي|جهونپي
جھونت|جهونت
جھونٽڻان|جهونٽڻان
جھونجھار|جهونجهار
جھونجھارڪو|جهونجهارڪو
جھونجھاڪڙو|جهونجهاڪڙو
جھونجھاڻ|جهونجهاڻ
جھونجھڙو|جهونجهڙو
جھونجھڻ|جهونجهڻ
جھونڊار|جهونڊار
جھونڊڻ|جهونڊڻ
جھونڊي|جهونڊي
جھونڪڻ|جهونڪڻ
جھونگار|جهونگار
جھونگارڻ|جهونگارڻ
جھونگڻ|جهونگڻ
جھونو|جهونو
جھوڻ|جهوڻ
جھوڻو|جهوڻو
جھوڻي|جهوڻي
جھي|جهي
جھيٻ|جهيٻ
جھيٻو|جهيٻو
جھيت|جهيت
جھيتو|جهيتو
جھيجا|جهيجا
جھير|جهير
جھيرائڻ|جهيرائڻ
جھيراڻ|جهيراڻ
جھيرٽ|جهيرٽ
جھيرڻ|جهيرڻ
جھيرڻو|جهيرڻو
جھيرڻيا|جهيرڻيا
جھيرو|جهيرو
جھيز|جهيز
جھيڙائڻ|جهيڙائڻ
جھيڙائي|جهيڙائي
جھيڙاڪ|جهيڙاڪ
جھيڙاڪر|جهيڙاڪر
جھيڙاڳڙ|جهيڙاڳڙ
جھيڙڻ|جهيڙڻ
جھيڙو|جهيڙو
جھيڙوڪرڻ|جهيڙوڪرڻ
جھيڪ|جهيڪ
جھيڪارڻ|جهيڪارڻ
جھيڪارو|جهيڪارو
جھيڪر|جهيڪر
جھيڪڻ|جهيڪڻ
جھيڪو|جهيڪو
جھيل|جهيل
جھيلار|جهيلار
جھيلاڙو|جهيلاڙو
جھيلو|جهيلو
جھيلي|جهيلي
جھيم|جهيم
جھيمڻ|جهيمڻ
جھينگار|جهينگار
جھينگارئڻ|جهينگارئڻ
جھينگارڻ|جهينگارڻ
جھينگاڙ|جهينگاڙ
جھينگر|جهينگر
جھينگڙ|جهينگڙ
جھينگڻ|جهينگڻ
جھينگو|جهينگو
جھيڻ|جهيڻ
جھيڻائي|جهيڻائي
جھيڻو|جهيڻو
جوئنده|جوئندہ
جوابدهي|جوابدهي
جواهر|جواھر
جواهرات|جواھرات
جواهري|جواھري
جوجھر|جوجهر
جوزهندي|جوزھندي
جوڙيئھ|جوڙيئہ
جوشانده|جوشاندہ
جولاهه|جولاھ
جولاهو|جولاھو
جونجھا|جونجها
جونجھارو|جونجهارو
جونجھه|جونجهہ
جوڻاهه|جوڻاھ
جوهئل|جوھئل
جوهاري|جوھاري
جوهر|جوھر
جوهردار|جوھردار
جوهري|جوھري
جوهريو|جوھريو
جوهڙ|جوھڙ
جوهڻ|جوھڻ
جوهه|جوھہ
جوهو|جوھو
جوهي|جوھي
جوينده|جويندہ
جيڏانهن|جيڏانھن
جيڏانهون|جيڏانھون
جيڏانهين|جيڏانھين
جيڏهان|جيڏھان
جيڏهن|جيڏھن
جيڏهين|جيڏھين
جيڪڏهن|جيڪڏھن
جيلانه|جيلانھ
جيلانهين|جيلانھين
جيلاهه|جيلاھ
جينجھر|جينجهر
جينجھري|جينجهري
جينهل|جينھل
جيها|جيھا
جيهر|جيھر
جيهل|جيھل
جيهو|جيھو
ڄاراهو|ڄاراھو
ڄاڙه|ڄاڙہ
ڄاڙهه|ڄاڙھہ
ڄاگھو|ڄاگهو
ڄامه|ڄامہ
ڄانگھر|ڄانگهر
ڄانگھڙيل|ڄانگهڙيل
ڄانگھو|ڄانگهو
ڄانگھي|ڄانگهي
ڄاڻڻهار|ڄاڻڻھار
ڄاهو|ڄاھو
ڄڄوها|ڄڄوھا
ڄڙهه|ڄڙھہ
ڄلھائي|ڄلهائي
ڄلھھ|ڄلهه
ڄلھو|ڄلهو
ڄنگھڙ|ڄنگهڙ
ڄنگھڙي|ڄنگهڙي
ڄنگھڙيل|ڄنگهڙيل
ڄنگھه|ڄنگهہ
ڄنگھون|ڄنگهون
ڄنگھي|ڄنگهي
ڄهيرو|ڄھيرو
چئه|چئہ
چاپاهه|چاپاھ
چاپهن|چاپھن
چاپهه|چاپھہ
چاره|چارہ
چاڙاهو|چاڙاھو
چاڙه|چاڙھ
چاڙهائڻ|چاڙھائڻ
چاڙهاڪا|چاڙھاڪا
چاڙهاڪو|چاڙھاڪو
چاڙهاڻي|چاڙھاڻي
چاڙهڻ|چاڙهڻ
چاڙهڻو|چاڙهڻو
چاڙهه|چاڙھہ
چاڙهو|چاڙھو
چاڙهي|چاڙھي
چاڙهيار|چاڙھيار
چاڙهيڪو|چاڙھيڪو
چاڙهيڪي|چاڙھيڪي
چاڙهين|چاڙھين
چاڙهيون|چاڙھيون
چالھيارو|چالهيارو
چاليهارو|چاليھارو
چاليهه|چاليھہ
چاليهو|چاليھو
چاليهون|چاليھون
چانگھار|چانگهار
چانگھارا|چانگهارا
چانگھارڻ|چانگهارڻ
چانگھارو|چانگهارو
چانگھه|چانگهہ
چانگھو|چانگهو
چانه|چانہ
چانهان|چانھان
چانهه|چانھہ
چانهون|چانھون
چانهين|چانھين
چانھه|چانھہ
چانيها|چانيھا
چانيهو|چانيھو
چاهڙ|چاھڙ
چاهڪ|چاھڪ
چاهڻ|چاھڻ
چاهه|چاھ
چاهي|چاھي
چاهيون|چاھيون
چاھھ|چاھہ
چٽيهو|چٽيھو
چراگاهه|چراگاھ
چرهات|چرھات
چرهاڻ|چرھاڻ
چرهو|چرھو
چڙه|چڙھ
چڙهئي|چڙھئي
چڙهاء|چڙھاء
چڙهائڻ|چڙھائڻ
چڙهائي|چڙھائي
چڙهاڪت|چڙھاڪت
چڙهان|چڙھان
چڙهت|چڙھت
چڙهتي|چڙھتي
چڙهڪ|چڙھڪ
چڙهندي|چڙھندي
چڙهڻ|چڙھڻ
چڙهڻي|چڙھڻي
چڙهه|چڙھہ
چڙهو|چڙھو
چڙهي|چڙھي
چڙهيو|چڙھيو
چڪيهه|چڪيھہ
چگھا|چگها
چگھر|چگهر
چگھڙ|چگهڙ
چگھنو|چگهنو
چگھڻ|چگهڻ
چگھه|چگهہ
چگھو|چگهو
چگھوٽو|چگهوٽو
چڳهه|چڳهہ
چُڳهَه|چُڳهَہ
چلغوزه|چلغوزہ
چلهه|چلهہ
چُلهه|چُلهہ
چلھا|چلها
چلھائڻ|چلهائڻ
چلھتو|چلهتو
چلھجڻ|چلهجڻ
چلھجي|چلهجي
چلھر|چلهر
چلھري|چلهري
چلھڻ|چلهڻ
چلھه|چلھہ
چلھو|چلهو
چلھي|چلهي
چمڪئه|چمڪئہ
چمهري|چمھري
چنجھائي|چنجهائي
چنجھو|چنجهو
چنگهه|چنگهہ
چنگھائڻ|چنگهائڻ
چنگھڪار|چنگهڪار
چنگھڻ|چنگهڻ
چنگھڻيون|چنگهڻيون
چنگھون|چنگهون
چنهر|چنھر
چنهه|چنھہ
چهائڻ|چھائڻ
چهار|چھار
چهانڊ|چھانڊ
چهانڊون|چھانڊون
چهبڪ|چھبڪ
چهٻچو|چھٻچو
چهٻر|چھٻر
چهٻري|چھٻري
چهٽڻ|چھٽڻ
چهچ|چھچ
چهچٽو|چھچٽو
چهڏ|چھڏ
چهر|چھر
چهرائي|چھرائي
چهراڻ|چھراڻ
چهره|چھرہ
چهرو|چھرو
چهري|چھري
چهريون|چھريون
چهڙ|چھڙ
چهڙا|چھڙا
چهڙائتو|چھڙائتو
چهڙڪي|چھڙڪي
چهڙو|چھڙو
چهڙي|چھڙي
چهڙيل|چھڙيل
چهڪ|چھڪ
چهڪڻ|چھڪڻ
چهڪو|چھڪو
چهل|چھل
چهلڙا|چھلڙا
چهلڙو|چھلڙو
چهلم|چھلم
چهلو|چھلو
چهن|چھن
چهنب|چھنب
چهنبدار|چھنبدار
چهنبدارون|چھنبدارون
چهنبر|چھنبر
چهنج|چھنج
چهنچ|چھنچ
چهنڊڙي|چھنڊڙي
چهنڊي|چھنڊي
چهنگ|چھنگ
چهنگارڻ|چھنگارڻ
چهنگر|چھنگر
چهڻ|چھڻ
چهه|چھہ
چهو|چھو
چهواڻ|چھواڻ
چهوڙڻ|چھوڙڻ
چهوڪي|چھوڪي
چهوڪيون|چھوڪيون
چهي|چھي
چوئيتاليهه|چوئيتاليھ
چوپهري|چوپھري
چوٽيهه|چوٽيھہ
چوڏنهن|چوڏنھن
چوڏها|چوڏھا
چوڏهن|چوڏھن
چوڏهون|چوڏھون
چوڏهين|چوڏھين
چوڏهيو|چوڏھيو
چوراهو|چوراھو
چولڙهه|چولڙھہ
چولھاٽ|چولهاٽ
چولھڙ|چولهڙ
چولھڙهه|چولهڙھہ
چومهري|چومھري
چونجھائي|چونجهائي
چونجھو|چونجهو
چونگھر|چونگهر
چونگھرون|چونگهرون
چونهه|چونھہ
چوڻاها|چوڻاھا
چوڻاهو|چوڻاھو
چوڻهار|چوڻھار
چوه|چوھ
چوهائڻ|چوھائڻ
چوهارا|چوھارا
چوهارو|چوھارو
چوهاڻ|چوھاڻ
چوهتر|چوھتر
چوهٺ|چوھٺ
چوهٽي|چوھٽي
چوهٽيون|چوھٽيون
چوهٿي|چوھٿي
چوهٿيون|چوھٿيون
چوهڙ|چوھڙ
چوهڙي|چوھڙي
چوهڻ|چوھڻ
چوهو|چوھو
چوهي|چوھي
چوونجاهه|چوونجاھ
چوويهه|چوويھ
چوويهو|چوويھو
چوويھه|چوويھہ
چيئه|چيئہ
چيجهه|چيجهہ
چيده|چيدھ
چيره|چيرہ
چيڙهارو|چيڙھارو
چيڙهالو|چيڙھالو
چيڙهڻو|چيڙھڻو
چيڙهه|چيڙھہ
چيڙهو|چيڙھو
چيلهه|چيلهہ
چيلھڪي|چيلهڪي
چيلھه|چيلهہ
چيلھو|چيلهو
چيلھيون|چيلهيون
چينجھڙ|چينجهڙ
چينجھڙو|چينجهڙو
چينگهه|چينگهہ
چينگھا|چينگها
چينگھاٽ|چينگهاٽ
چينگھارڻ|چينگهارڻ
چينگھٽ|چينگهٽ
چينگھڙ|چينگهڙ
چينگھڻ|چينگهڻ
چينگھو|چينگهو
چينهه|چينھہ
چيها|چيھا
چيهاٽ|چيھاٽ
چيهاٽون|چيھاٽون
چيهاڙ|چيھاڙ
چيهاڙيون|چيھاڙيون
چيهاڻي|چيھاڻي
چيهل|چيھل
چيهه|چيھہ
چيهو|چيھو
ڇائيتاليهه|ڇائيتاليھ
ڇاٻاهي|ڇاٻاھي
ڇاڏهول|ڇاڏھول
ڇاڏوهڙ|ڇاڏوھڙ
ڇاڙهه|ڇاڙھہ
ڇاڙهو|ڇاڙھو
ڇاڙهي|ڇاڙھي
ڇانگهه|ڇانگهہ
ڇانگھر|ڇانگهر
ڇانگھڻ|ڇانگهڻ
ڇانهر|ڇانھر
ڇانهولو|ڇانھولو
ڇانهون|ڇانھون
ڇانهي|ڇانھي
ڇانهيال|ڇانھيال
ڇانهين|ڇانھين
ڇاهاني|ڇاھاني
ڇاهتر|ڇاھتر
ڇاهٺ|ڇاھٺ
ڇاهل|ڇاھل
ڇاهو|ڇاھو
ڇاهوٽڻ|ڇاھوٽڻ
ڇاهون|ڇاھون
ڇاهي|ڇاھي
ڇاونجاهه|ڇاونجاھ
ڇپڻهار|ڇپڻھار
ڇٽيهه|ڇٽيھ
ڇٽيهو|ڇٽيھو
ڇڄهري|ڇڄھري
ڇڇوهر|ڇڇوھر
ڇرهو|ڇرھو
ڇريهر|ڇريھر
ڇڙڳاهي|ڇڙڳاھي
ڇڙه|ڇڙھ
ڇڙهائي|ڇڙھائي
ڇڙهاٽ|ڇڙھاٽ
ڇڙهه|ڇڙھہ
ڇڙهو|ڇڙھو
ڇڙهون|ڇڙھون
ڇڙهي|ڇڙھي
ڇڙهيدار|ڇڙھيدار
ڇڙهيون|ڇڙھيون
ڇلهه|ڇلهہ
ڇلھوري|ڇلهوري
ڇماهي|ڇماھي
ڇنگهه|ڇنگهہ
ڇنگھو|ڇنگهو
ڇنهڙو|ڇنھڙو
ڇنهون|ڇنھون
ڇه|ڇھ
ڇهئي|ڇھئي
ڇهائڻ|ڇھائڻ
ڇهائي|ڇھائي
ڇهارا|ڇھارا
ڇهارو|ڇھارو
ڇهاس|ڇھاس
ڇهاسي|ڇھاسي
ڇهانوي|ڇھانوي
ڇهاڻي|ڇھاڻي
ڇهر|ڇھر
ڇهڙ|ڇھڙ
ڇهڙائپ|ڇھڙائپ
ڇهڙم|ڇھڙم
ڇهل|ڇھل
ڇهلائڻ|ڇھلائڻ
ڇهنڊ|ڇھنڊ
ڇهنڊڻ|ڇھنڊڻ
ڇهنڊو|ڇھنڊو
ڇهنگڻ|ڇھنگڻ
ڇهڻ|ڇھڻ
ڇهه|ڇھہ
ڇهو|ڇھو
ڇهوتر|ڇھوتر
ڇهوترو|ڇھوترو
ڇهون|ڇھون
ڇهوڻ|ڇھوڻ
ڇهوڻو|ڇھوڻو
ڇهي|ڇھي
ڇهين|ڇھين
ڇھه|ڇھہ
ڇوڏاهو|ڇوڏاھو
ڇوهائي|ڇوھائي
ڇوهارو|ڇوھارو
ڇوهر|ڇوھر
ڇوهه|ڇوھہ
ڇوهو|ڇوھو
ڇوهي|ڇوھي
ڇوهيڪار|ڇوھيڪار
ڇوهيو|ڇوھيو
ڇويهه|ڇويھہ
ڇيڄهڙو|ڇيڄھڙو
ڇيڙهڻ|ڇيڙھڻ
ڇيڙهه|ڇيڙھہ
ڇيڙهون|ڇيڙھون
ڇينگھو|ڇينگهو
ڇينهرو|ڇينھرو
ڇينهڙا|ڇينھڙا
ڇينهڙو|ڇينھڙو
ڇيڻهار|ڇيڻھار
ڇيڻھو|ڇيڻهو
ڇيهڙ|ڇيھڙ
ڇيهڙو|ڇيھڙو
ڇيهل|ڇيھل
ڇيهلو|ڇيھلو
ڇيهڻ|ڇيھڻ
ڇيهه|ڇيھہ
ڇيهو|ڇيھو
ڇيهون|ڇيھون
ڇيهي|ڇيھي
حاسه|حاسہ
حاشيه|حاشيہ
حافظه|حافظہ
حاڪمانه|حاڪمانہ
حاليه|حاليہ
حامله|حاملہ
حجابانه|حجابانہ
حجره|حجرہ
حجله|حجلہ
حده|حدہ
حديبيه|حديبيہ
حربگاهه|حربگاھ
حربه|حربہ
حسنه|حسنہ
حسينه|حسينہ
حلاله|حلالہ
حلقئه|حلقئہ
حلقه|حلقہ
حمزه|حمزہ
حمله|حملہ
حميده|حميدہ
حنيفه|حنيفہ
حوصله|حوصلہ
خاتمه|خاتمہ
خارجه|خارجہ
خاڪاهو|خاڪاھو
خانبهادر|خانبھادر
خانقاهه|خانقاھ
خانگاهه|خانگاھ
خانه|خانہ
خانواده|خانوادہ
خانواهڻ|خانواھڻ
خانواهه|خانواھ
خايه|خايہ
خبيثه|خبيثہ
خجسته|خجستہ
خديجه|خديجہ
خرارهئڻ|خرارھئڻ
خرده|خردہ
خرقه|خرقہ
خرگاهه|خرگاھ
خرمهره|خرمهرہ
خزانه|خزانہ
خزيمه|خزيمہ
خزينه|خزينہ
خسته|خستہ
خسروانه|خسروانہ
خطه|خطہ
خفته|خفتہ
خفيه|خفيہ
خلقڻهار|خلقڻھار
خليفه|خليفہ
خميده|خميدہ
خنده|خندہ
خواجه|خواجہ
خواسته|خواستہ
خوانده|خواندہ
خواه|خواھ
خواهان|خواھان
خواهر|خواھر
خواهش|خواھش
خواهشمند|خواھشمند
خواهه|خواھ
خواهي|خواھي
خورده|خوردہ
خوشه|خوشہ
خيرخواهه|خيرخواھ
خيره|خيرہ
خيمه|خيمه
دادخواهي|دادخواھي
داددهش|داددھش
داڙهه|داڙھہ
داسنگهه|داسنگهہ
داشته|داشتہ
دالهن|دالهن
داناهه|داناھ
داناهي|داناھي
دانسته|دانستہ
دانهن|دانھن
دانهنر|دانھنر
دانهڻ|دانھڻ
دانهه|دانھہ
دانهوڙي|دانھوڙي
دانهون|دانھون
دانهير|دانھير
دانهين|دانھين
داهڙ|داھڙ
داهه|داھ
دٻهڙو|دٻھڙو
دتاهو|دتاھو
دتهڻڻ|دتھڻڻ
دجله|دجلہ
دراهم|دراھم
دراهو|دراھو
دراهي|دراھي
درپرده|درپردہ
درسگاهه|درسگاھ
درشهوار|درشھوار
درگاهه|درگاھ
درگهه|درگهہ
درمانده|درماندہ
درماهه|درماھ
درماهو|درماھو
دره|درہ
درها|درھا
درهڙ|درھڙ
درهم|درھم
درهي|درھي
دروهه|دروھہ
دروهي|دروھي
درياهه|درياھ
درياهي|درياھي
درياھھ|درياھہ
دڙرڪارهجڻ|دڙرڪارھجڻ
دڙها|دڙھا
دڙهر|دڙھر
دڙهڙ|دڙھڙ
دڙهو|دڙھو
دڙهي|دڙھي
دسته|دستہ
دسهڙو|دسھڙو
دعاگھرڻ|دعاگهرڻ
دغدغه|دغدغہ
دڪه|دڪہ
دلهير|دلھير
دليرانه|دليرانہ
دمبها|دمبھا
دمبهو|دمبھو
دمهڙو|دمھڙو
دمهيا|دمھيا
دنجهه|دنجهہ
ده|دہ
دهائي|دھائي
دهات|دھات
دهاتي|دھاتي
دهان|دھان
دهانو|دھانو
دهاني|دھاني
دهدار|دھدار
دهر|دھر
دهرا|دھرا
دهرائڻ|دھرائڻ
دهرم|دھرم
دهرڻ|دھرڻ
دهرو|دھرو
دهري|دھري
دهريارو|دھريارو
دهريه|دھريہ
دهريو|دھريو
دهڙو|دھڙو
دهشت|دھشت
دهشتناڪ|دھشتناڪ
دهشتي|دھشتي
دهقان|دھقان
دهقاني|دھقاني
دهڪ|دھڪ
دهڪائڻ|دھڪائڻ
دهڪار|دھڪار
دهڪارو|دھڪارو
دهڪڻ|دھڪڻ
دهڪو|دھڪو
دهل|دھل
دهلائڻ|دھلائڻ
دهلاري|دھلاري
دهلتي|دھلتي
دهلجڻ|دھلجڻ
دهلڙي|دھلڙي
دهلڻ|دھلڻ
دهلو|دھلو
دهلوارو|دھلوارو
دهلوي|دھلوي
دهلي|دھلي
دهليز|دھليز
دهم|دھم
دهمان|دھمان
دهماني|دھماني
دهمڙدو|دھمڙدو
دهن|دھن
دهنر|دھنر
دهه|دھہ
دهو|دھو
دهوار|دھوار
دهوڙجن|دھوڙجن
دهوڙڻ|دھوڙڻ
دهي|دھي
دهيلا|دھيلا
دهيون|دھيون
دوباره|دوبارہ
دوپهري|دوپھري
دوپيازه|دوپيازہ
دوتهو|دوتھو
دوجهان|دوجھان
دوراهو|دوراھو
دوزخوهائڻ|دوزخوھائڻ
دوڙهيو|دوڙھيو
دوساهه|دوساھ
دوشنبه|دوشنبہ
دوشيزه|دوشيزہ
دوشينه|دوشينہ
دولهه|دولهہ
دونهائجڻ|دونھائجڻ
دونهائڻ|دونھائڻ
دونهاٽ|دونھاٽ
دونهاٽجڻ|دونھاٽجڻ
دونهاٽڻ|دونھاٽڻ
دونهارو|دونھارو
دونهاڙ|دونھاڙ
دونهان|دونھان
دونهانئڻ|دونھانئڻ
دونهاڻڪو|دونھاڻڪو
دونهه|دونھہ
دونهون|دونھون
دونهي|دونھي
دونهيارو|دونھيارو
دونهياري|دونھياري
دونهيرو|دونھيرو
دونهين|دونھين
دوهاري|دوھاري
دوهاڻي|دوھاڻي
دوهر|دوھر
دوهرو|دوھرو
دوهري|دوھري
دوهڙ|دوھڙ
دوهڙو|دوھڙو
دوهو|دوھو
ديده|ديدہ
ديهات|ديھات
ديهاتي|ديھاتي
ديهاڻي|ديھاڻي
ديهڌاري|ديھڌاري
ديهه|ديھہ
ديهي|ديھي
ذائقه|ذائقہ
ذاده|ذادہ
ذره|ذرہ
ذمه|ذمہ
ذهب|ذھب
ذهن|ذھن
ذهني|ذھني
ذهين|ذھين
ڊاٻهاڙو|ڊاٻھاڙو
ڊاماهو|ڊاماھو
ڊانهر|ڊانھر
ڊاهڻ|ڊاھڻ
ڊاهه|ڊاھ
ڊاهو|ڊاھو
ڊاهي|ڊاھي
ڊاهيون|ڊاھيون
ڊٽهڙو|ڊٽھڙو
ڊڙهتا|ڊڙهتا
ڊڙهه|ڊڙھہ
ڊگهه|ڊگهہ
ڊگھا|ڊگها
ڊگھائي|ڊگهائي
ڊگھارڻ|ڊگهارڻ
ڊگھاڻ|ڊگهاڻ
ڊگھرائين|ڊگهرائين
ڊگھرس|ڊگهرس
ڊگھڙ|ڊگهڙ
ڊگھڙي|ڊگهڙي
ڊگھل|ڊگهل
ڊگھو|ڊگهو
ڊگھوش|ڊگهوش
ڊگھي|ڊگهي
ڊگھير|ڊگهير
ڊگھيرڙو|ڊگهيرڙو
ڊگھيرڻ|ڊگهيرڻ
ڊگھيرو|ڊگهيرو
ڊگھيڙڻ|ڊگهيڙڻ
ڊگھيون|ڊگهيون
ڊنبهو|ڊنبھو
ڊنڊمرهياري|ڊنڊمرھياري
ڊنگھر|ڊنگهر
ڊه|ڊھ
ڊها|ڊھا
ڊهجڻ|ڊھجڻ
ڊهر|ڊھر
ڊهڪل|ڊھڪل
ڊهلڻ|ڊھلڻ
ڊهنڊي|ڊھنڊي
ڊهڻ|ڊھڻ
ڊهه|ڊھہ
ڊهو|ڊھو
ڊهوم|ڊھوم
ڊهون|ڊھون
ڊهي|ڊھي
ڊهيا|ڊھيا
ڊوهاڙ|ڊوھاڙ
ڊوهان|ڊوھان
ڊوهڙو|ڊوھڙو
ڊوهڻ|ڊوھڻ
ڊوهه|ڊوھہ
ڊوهو|ڊوھو
ڊوهي|ڊوھي
ڊوهـي|ڊوھـي
ڊوهيون|ڊوھيون
ڊيگهه|ڊيگهہ
ڊيگھي|ڊيگهي
ڊينگھر|ڊينگهر
ڊينگھو|ڊينگهو
ڊيها|ڊيھا
ڊيهاڙ|ڊيھاڙ
ڊيهڙ|ڊيھڙ
ڊيهڙو|ڊيھڙو
ڊيهه|ڊيھہ
ڊيهو|ڊيھو
ڊيهوڙ|ڊيھوڙ
ڌامراها|ڌامراھا
ڌامراهه|ڌامراھ
ڌامراهو|ڌامراھو
ڌرماهي|ڌرماھي
ڌڙهڙ|ڌڙھڙ
ڌڙهير|ڌڙھير
ڌوهو|ڌوھو
ڌيڄاهو|ڌيڄاھو
ڍانگھر|ڍانگهر
ڍاهر|ڍاھر
ڍاهو|ڍاھو
ڍڪڻهار|ڍڪڻھار
ڍنگھر|ڍنگهر
ڍنگھري|ڍنگهري
ڍهٽ|ڍھٽ
ڍهنڍ|ڍھنڍ
ڍهنڍي|ڍھنڍي
ڍهو|ڍھو
ڍهي|ڍھي
ڍوهو|ڍوھو
ڍينگھر|ڍينگهر
ڍينگھرن|ڍينگهرن
ڍينگھو|ڍينگهو
ڏاجهه|ڏاجهہ
ڏاجھو|ڏاجهو
ڏاجھوڙو|ڏاجهوڙو
ڏاجھيرو|ڏاجهيرو
ڏاڏاهه|ڏاڏاھ
ڏاڙهائڻ|ڏاڙھائڻ
ڏاڙهر|ڏاڙھر
ڏاڙهڻ|ڏاڙھڻ
ڏاڙهه|ڏاڙھہ
ڏاڙهون|ڏاڙھون
ڏاڙهي|ڏاڙھي
ڏاڙهيء|ڏاڙھيء
ڏاڙهيار|ڏاڙھيار
ڏاڙهيارو|ڏاڙھيارو
ڏاڙهيو|ڏاڙھيو
ڏاڙيهو|ڏاڙيھو
ڏاکڻاه|ڏاکڻاھ
ڏاگهه|ڏاگهہ
ڏاگھڙ|ڏاگهڙ
ڏاگھڻ|ڏاگهڻ
ڏاگھو|ڏاگهو
ڏالھي|ڏالهي
ڏاناهي|ڏاناھي
ڏانجهه|ڏانجهہ
ڏانجھو|ڏانجهو
ڏانگهه|ڏانگهہ
ڏانهس|ڏانھس
ڏانهن|ڏانھن
ڏانهه|ڏانھہ
ڏانهون|ڏانھون
ڏانهين|ڏانھين
ڏاهئين|ڏاھئين
ڏاهاڻو|ڏاھاڻو
ڏاهاڻي|ڏاھاڻي
ڏاهپ|ڏاھپ
ڏاهر|ڏاھر
ڏاهرڪي|ڏاھرڪي
ڏاهري|ڏاھري
ڏاهڙو|ڏاھڙو
ڏاهلڻ|ڏاھلڻ
ڏاهلي|ڏاھلي
ڏاهنئن|ڏاھنئن
ڏاهه|ڏاھ
ڏاهو|ڏاھو
ڏاهي|ڏاھي
ڏاهيجا|ڏاھيجا
ڏاھھ|ڏاھہ
ڏٻهه|ڏٻھہ
ڏپهرو|ڏپھرو
ڏجهه|ڏجهه
ڏجھارو|ڏجهارو
ڏجھڻ|ڏجهڻ
ڏجھو|ڏجهو
ڏرگھڻ|ڏرگهڻ
ڏرهائڻ|ڏرھائڻ
ڏرهه|ڏرھہ
ڏڙه|ڏڙھ
ڏڙهڻ|ڏڙھڻ
ڏڙهه|ڏڙھہ
ڏڙهو|ڏڙھو
ڏڙهي|ڏڙھي
ڏڙهيون|ڏڙھيون
ڏکڻهاري|ڏکڻھاري
ڏگهه|ڏگهہ
ڏگھچڙ|ڏگهچڙ
ڏگھر|ڏگهر
ڏگھري|ڏگهري
ڏگھڪي|ڏگهڪي
ڏگھلو|ڏگهلو
ڏگھو|ڏگهو
ڏلاه|ڏلاھ
ڏلهه|ڏلهہ
ڏلھا|ڏلها
ڏلھائي|ڏلهائي
ڏلھجڻ|ڏلهجڻ
ڏلھر|ڏلهر
ڏلھڻ|ڏلهڻ
ڏلھو|ڏلهو
ڏمهوگي|ڏمھوگي
ڏنجهه|ڏنجهه
ڏنجھڻ|ڏنجهڻ
ڏنجھو|ڏنجهو
ڏنگهه|ڏنگهہ
ڏنگھو|ڏنگهو
ڏنهر|ڏنھر
ڏنهن|ڏنھن
ڏنهنڪ|ڏنھنڪ
ڏنهه|ڏنھہ
ڏنهوڪو|ڏنھوڪو
ڏنهون|ڏنھون
ڏنهونڏنهن|ڏنھونڏنھن
ڏنهوڻڪو|ڏنھوڻڪو
ڏنهوڻو|ڏنھوڻو
ڏنهي|ڏنھي
ڏڻهن|ڏڻھن
ڏه|ڏھ
ڏها|ڏھا
ڏهائڻ|ڏھائڻ
ڏهائو|ڏھائو
ڏهائي|ڏھائي
ڏهاڄ|ڏھاڄ
ڏهاري|ڏھاري
ڏهاڙو|ڏھاڙو
ڏهاڙي|ڏھاڙي
ڏهاڪو|ڏھاڪو
ڏهاڳ|ڏھاڳ
ڏهاڳجڻ|ڏھاڳجڻ
ڏهاڳڻ|ڏھاڳڻ
ڏهاڳي|ڏھاڳي
ڏهان|ڏھان
ڏهاڻي|ڏھاڻي
ڏهٽاڻ|ڏھٽاڻ
ڏهٽو|ڏھٽو
ڏهر|ڏھر
ڏهــر|ڏھر
ڏهرا|ڏھرا
ڏهراج|ڏھراج
ڏهرجا|ڏھرجا
ڏهرڪي|ڏھرڪي
ڏهرنگ|ڏھرنگ
ڏهرو|ڏھرو
ڏهري|ڏھري
ڏهڙاڳ|ڏھڙاڳ
ڏهس|ڏھس
ڏهسئو|ڏھسئو
ڏهسنامو|ڏھسنامو
ڏهکاڄ|ڏھکاڄ
ڏهڪاء|ڏھڪاء
ڏهڪائجڻ|ڏھڪائجڻ
ڏهڪار|ڏھڪار
ڏهڪجڻ|ڏھڪجڻ
ڏهڪڻ|ڏھڪڻ
ڏهل|ڏھل
ڏهلائي|ڏھلائي
ڏهلو|ڏھلو
ڏهلي|ڏھلي
ڏهن|ڏھن
ڏهنئن|ڏھنئن
ڏهنائي|ڏھنائي
ڏهنايون|ڏھنايون
ڏهنور|ڏھنور
ڏهڻ|ڏھڻ
ڏهڻجو|ڏھڻجو
ڏهڻو|ڏھڻو
ڏهه|ڏھہ
ڏهو|ڏھو
ڏهوتر|ڏھوتر
ڏهوترو|ڏھوترو
ڏهوٽ|ڏھوٽ
ڏهوچ|ڏھوچ
ڏهون|ڏھون
ڏهوڻ|ڏھوڻ
ڏهوڻائي|ڏھوڻائي
ڏهوڻو|ڏھوڻو
ڏهي|ڏھي
ڏهيا|ڏھيا
ڏهيت|ڏھيت
ڏهيترو|ڏھيترو
ڏهيٽرو|ڏھيٽرو
ڏهيٽي|ڏھيٽي
ڏهيرائي|ڏھيرائي
ڏهيرو|ڏھيرو
ڏهيڙو|ڏھيڙو
ڏهيسر|ڏھيسر
ڏهيل|ڏھيل
ڏهيلائي|ڏھيلائي
ڏهيلو|ڏھيلو
ڏهين|ڏھين
ڏهيون|ڏھيون
ڏوجهه|ڏوجهہ
ڏوجھارو|ڏوجهارو
ڏوجھرو|ڏوجهرو
ڏوجھو|ڏوجهو
ڏوڏهار|ڏوڏھار
ڏورانهون|ڏورانھون
ڏورانهين|ڏورانھين
ڏورهو|ڏورھو
ڏورهين|ڏورھين
ڏوڙهو|ڏوڙھو
ڏوکاهو|ڏوکاھو
ڏوکاهي|ڏوکاھي
ڏوگهه|ڏوگهہ
ڏوگھا|ڏوگها
ڏوگھان|ڏوگهان
ڏوگھر|ڏوگهر
ڏوگھلو|ڏوگهلو
ڏوگھڻ|ڏوگهڻ
ڏوگھو|ڏوگهو
ڏوگھي|ڏوگهي
ڏوڳاھو|ڏوڳاھو
ڏولهه|ڏولهہ
ڏولھڻ|ڏولهڻ
ڏولھو|ڏولهو
ڏولھي|ڏولهي
ڏونجھو|ڏونجهو
ڏونگھا|ڏونگها
ڏونگھن|ڏونگهن
ڏونگھو|ڏونگهو
ڏونگھي|ڏونگهي
ڏونگھيء|ڏونگهيء
ڏونه|ڏونھ
ڏونهن|ڏونھن
ڏونهو|ڏونھو
ڏونهون|ڏونھون
ڏوهائتو|ڏوھائتو
ڏوهائي|ڏوھائي
ڏوهاري|ڏوھاري
ڏوهاڳ|ڏوھاڳ
ڏوهپڻ|ڏوھپڻ
ڏوهٽ|ڏوھٽ
ڏوهٽاڻ|ڏوھٽاڻ
ڏوهٽاڻو|ڏوھٽاڻو
ڏوهٽو|ڏوھٽو
ڏوهٽي|ڏوھٽي
ڏوهر|ڏوھر
ڏوهري|ڏوھري
ڏوهڙو|ڏوھڙو
ڏوهلو|ڏوھلو
ڏوهه|ڏوھہ
ڏوهو|ڏوھو
ڏوهور|ڏوھور
ڏوهي|ڏوھي
ڏوهيترو|ڏوھيترو
ڏوهيڙو|ڏوھيڙو
ڏيراه|ڏيراھ
ڏيلهه|ڏيلهہ
ڏيلھو|ڏيلهو
ڏيلھون|ڏيلهون
ڏينهئي|ڏينھئي
ڏينهاڙي|ڏينھاڙي
ڏينهان|ڏينھان
ڏينهگڻ|ڏينهگڻ
ڏينهن|ڏينھن
ڏينهنچي|ڏينھنچي
ڏينهنڪ|ڏينھنڪ
ڏينهوڪو|ڏينھوڪو
ڏينهون|ڏينھون
ڏينهونئي|ڏينھونئي
ڏينهوڻو|ڏينھوڻو
ڏيهائتا|ڏيھائتا
ڏيهارو|ڏيھارو
ڏيهاڙو|ڏيھاڙو
ڏيهاڙي|ڏيھاڙي
ڏيهان|ڏيھان
ڏيهاڻو|ڏيھاڻو
ڏيهاڻي|ڏيھاڻي
ڏيهر|ڏيھر
ڏيهرو|ڏيھرو
ڏيهن|ڏيھن
ڏيهه|ڏيھہ
ڏيهي|ڏيھي
ڏيھه|ڏيھہ
ڏيھھ|ڏيھہ
رئڻهارڪو|رئڻھارڪو
رئيسه|رئيسھ
رابعه|رابعہ
راتاهو|راتاھو
راڄمهـلـي|راڄمھـلـي
راڄواهه|راڄواھ
راده|رادہ
راڙهه|راڙھہ
راڙهو|راڙھو
راشتريه|راشتريہ
راشده|راشدہ
راگھٽ|راگهٽ
رانباهڻ|رانباھڻ
رانباهه|رانباھ
رانجھا|رانجها
رانجھاپور|رانجهاپور
رانجھن|رانجهن
رانجھو|رانجهو
رانده|راندہ
رانهان|رانھان
راڻاهه|راڻاھ
راڻاهو|راڻاھو
راهؤن|راھؤن
راهب|راھب
راهـبـر|راھـبـر
راهـبــر|راھـبــر
راهـدار|راھـدار
راهدار|راھدار
راهداري|راھداري
راهرو|راھرو
راهزن|راھزن
راهزني|راھزني
راهڙ|راھڙ
راهڪ|راھڪ
راهڪي|راھڪي
راهگذر|راھگذر
راهگير|راھگير
راهما|راھما
راهمار|راھمار
راهماري|راھماري
راهمو|راھمو
راهمور|راھمور
راهن|راھن
راهنما|راھنما
راهنمائي|راھنمائي
راهڻ|راھڻ
راهه|راھ
راهـه|راھـہ
راههَ|راهہَ
راهو|راھو
راهوار|راھوار
راهواري|راھواري
راهواڻي|راھواڻي
راهوٺ|راھوٺ
راهوجا|راھوجا
راهوڪڙا|راھوڪڙا
راهوڪي|راھوڪي
راهونڊ|راھونڊ
راهونڊڙو|راھونڊڙو
راهوڻي|راھوڻي
راهي|راھي
راهيجا|راھيجا
راهير|راھير
رپرده|رپردہ
رجهه|رجهہ
رجھائڻ|رجهائڻ
رجھڻ|رجهڻ
رچهر|رچھر
رخنه|رخنہ
ردالوده|ردالودہ
رزاده|رزادہ
رزمگاهه|رزمگاھ
رڙهڪڻ|رڙهڪڻ
رڙهڻ|رڙهڻ
رڙهي|رڙهي
رسيده|رسيدہ
رضيه|رضيہ
رفاه|رفاھ
رفته|رفتہ
رقاصه|رقاصہ
رقبه|رقبہ
رکڻهار|رکڻھار
رگاهه|رگاھ
رگاهي|رگاھي
رگهه|رگهہ
رگھائتو|رگهائتو
رگھارو|رگهارو
رگھٽو|رگهٽو
رگھٽي|رگهٽي
رگھو|رگهو
رگھي|رگهي
رلھڪو|رلهڪو
رلھي|رلهي
رماه|رماھ
رماهه|رماھ
رماهو|رماھو
رنجهه|رنجهہ
رنجيده|رنجيدہ
رنگهه|رنگهہ
رڻجهه|رڻجهہ
رها|رھا
رهائش|رھائش
رهائڻ|رھائڻ
رهائو|رھائو
رهائي|رھائي
رهائيندو|رھائيندو
رهاڙ|رھاڙ
رهاست|رھاست
رهاش|رھاش
رهاشت|رھاشت
رهاشو|رھاشو
رهاڪو|رھاڪو
رهانو|رھانو
رهاڻ|رھاڻ
رهاڻي|رھاڻي
رهاولزئي|رھاولزئي
رهاوي|رھاوي
رهبان|رھبان
رهبانيت|رھبانيت
رهبر|رھبر
رهبري|رھبري
رهٻٽ|رھٻٽ
رهپهه|رھپھہ
رهت|رھت
رهتوان|رھتوان
رهٽ|رھٽ
رهٽڻ|رھٽڻ
رهٽو|رھٽو
رهجي|رھجي
رهچ|رھچ
رهدار|رھدار
رهرو|رھرو
رهروان|رھروان
رهز|رھز
رهزادي|رھزادي
رهزاري|رھزاري
رهزن|رھزن
رهزني|رھزني
رهڙ|رھڙ
رهڙڪي|رھڙڪي
رهڙڻ|رھڙڻ
رهڙو|رھڙو
رهڙي|رھڙي
رهس|رھس
رهسائڻ|رھسائڻ
رهسڻ|رھسڻ
رهسو|رھسو
رهڪ|رھڪ
رهگذر|رھگذر
رهل|رھل
رهلو|رھلو
رهن|رھن
رهنت|رھنت
رهند|رھند
رهندو|رھندو
رهنڊ|رھنڊ
رهنڊڻ|رھنڊڻ
رهنڊو|رھنڊو
رهنڪار|رھنڪار
رهنڪو|رھنڪو
رهنما|رھنما
رهنمائي|رھنمائي
رهڻ|رھڻ
رهڻو|رھڻو
رهڻي|رھڻي
رهه|رھہ
رهو|رھو
رهوائڻ|رھوائڻ
رهوار|رھوار
رهواسي|رھواسي
رهوال|رھوال
رهواڻي|رھواڻي
رهور|رھور
رهي|رھي
رهياڪو|رھياڪو
رهيجي|رھيجي
رهيگ|رھيگ
رهيلو|رھيلو
رهين|رھين
رهيو|رھيو
رھھ|رھہ
روانه|روانہ
رواهه|رواھ
رواهي|رواھي
روباهه|روباھ
روباهي|روباھي
روپاه|روپاھ
روپهر|روپھر
روپهرو|روپھرو
روپهري|روپھري
روجهه|روجهہ
روجھام|روجهام
روجھاڻ|روجهاڻ
روجھاڻي|روجهاڻي
روجھو|روجهو
روزه|روزھ
روڙهڻ|روڙھڻ
روڙهه|روڙھہ
روڙهو|روڙھو
روڙهي|روڙھي
روسياه|روسياھ
روسياهي|روسياھي
روضهء|روضہء
رولھا|رولها
رونجهه|رونجهہ
رونجھا|رونجها
رونجھاڻي|رونجهاڻي
رونجھو|رونجهو
رونده|روندہ
رونگھا|رونگها
رونگھاٽ|رونگهاٽ
رونگھڏي|رونگهڏي
رونهارو|رونھارو
رونهاڙو|رونھاڙو
روه|روھ
روها|روھا
روهاڪي|روھاڪي
روهڙ|روھڙ
روهڙڻ|روھڙڻ
روهڙو|روھڙو
روهڙي|روھڙي
روهلاڻي|روھلاڻي
روهلڙي|روھلڙي
روهلو|روھلو
روهڻ|روھڻ
روهه|روهہ
روهو|روھو
روهي|روھي
روهيڙو|روھيڙو
روهيڙي|روھيڙي
روهيل|روھيل
روهيلا|روھيلا
روهيلو|روھيلو
روهيون|روھيون
رياهه|رياھ
رياهي|رياھي
ريجهه|ريجهہ
ريجھائڻ|ريجهائڻ
ريجھاڻو|ريجهاڻو
ريجھڪ|ريجهڪ
ريجھڻ|ريجهڻ
ريخته|ريختہ
ريزه|ريزہ
ريڙه|ريڙھ
ريڙهڻ|ريڙهڻ
ريڙهه|ريڙهہ
ريڙهو|ريڙھو
ريڙهي|ريڙھي
ريگماهي|ريگماھي
ريگھڙي|ريگهڙي
ريگھي|ريگهي
رينگهه|رينگهہ
ريهائڻ|ريھائڻ
ريهاٽ|ريھاٽ
ريهان|ريھان
ريهجڻ|ريھجڻ
ريهندو|ريھندو
ريهڻ|ريھڻ
ريهه|ريھہ
ريهو|ريھو
ريهون|ريھون
ريوزه|ريوزہ
زائيده|زائيدہ
زاده|زادہ
زاهد|زاھد
زاهدي|زاھدي
زاويه|زاويہ
زبده|زبدہ
زبيده|زبيدہ
زچّه|زچّہ
زده|زدہ
زرچڙهڻ|زرچڙھڻ
زرهه|زرھہ
زمانه|زمانہ
زمهرير|زمھرير
زناهه|زناھ
زناهي|زناھي
زنده|زندہ
زنهار|زنھار
زهبند|زھبند
زهد|زھد
زهر|زھر
زهرا|زھرا
زهراڻي|زھراڻي
زهرباد|زھرباد
زهردار|زھردار
زهرڪو|زھرڪو
زهره|زھرہ
زهرو|زھرو
زهري|زھري
زهريلو|زھريلو
زهمر|زھمر
زهمي|زھمي
زهه|زھہ
زهون|زھون
زهي|زھي
زهير|زھير
زوجه|زوجہ
زوجهه|زوجهہ
زياده|زيادہ
زيادهه|زيادھہ
زيهاداڻي|زيھاداڻي
زيهه|زيھہ
ڙاهه|ڙاھ
سائوڪارتهو|سائوڪارتھو
ساٻانگھي|ساٻانگهي
ساتاهو|ساتاھو
ساجناه|ساجناھ
ساجهه|ساجهہ
ساجھر|ساجهر
ساڃاهه|ساڃاھ
ساڃاهو|ساڃاھو
ساڃاهي|ساڃاھي
ساڃهڻ|ساڃھڻ
ساڃهڻو|ساڃھڻو
ساڃهه|ساڃھہ
ساڃهو|ساڃھو
ساڃھھ|ساڃھہ
ساخته|ساختہ
ساڏوهي|ساڏوھي
ساراهڻ|ساراھڻ
ساراهه|ساراھ
سارنگھيار|سارنگهيار
سارهه|سارھہ
سارهوري|سارھوري
سازنده|سازندہ
ساڙنهه|ساڙنھہ
ساڙهه|ساڙھہ
ساڙهو|ساڙھو
ساڙهي|ساڙھي
ساگھر|ساگهر
ساڱاهتو|ساڱاھتو
ساڱاهجڻ|ساڱاھجڻ
ساڱاهڻ|ساڱاھڻ
ساڱاهه|ساڱاھ
ساڱاهو|ساڱاھو
ساڱاهي|ساڱاھي
ساڱهه|ساڱهہ
ساڱهو|ساڱھو
ساڳاهي|ساڳاھي
سالاهڻ|سالاھڻ
سالگره|سالگرہ
سالها|سالھا
سامعه|سامعہ
سامنهر|سامنھر
سامھائي|سامهائي
سامھڻائي|سامهڻائي
سامھڻو|سامهڻو
سامھون|سامهون
سامھي|سامهي
سامھين|سامهين
ساموهي|ساموھي
سانباهڻ|سانباھڻ
سانباهه|سانباھ
سانباهو|سانباھو
سانباهي|سانباھي
سانبوهي|سانبوھي
سانبوهيون|سانبوھيون
سانجهَه|سانجهَہ
سانجھاڻي|سانجهاڻي
سانجھھ|سانجھہ
سانجھي|سانجهي
سانجھيجا|سانجهيجا
سانجھيڪو|سانجهيڪو
سانڃاهه|سانڃاھ
ساندهه|ساندھ
سانگاهڻ|سانگاھڻ
سانگاهي|سانگاھي
سانگهه|سانگهہ
سانگھائي|سانگهائي
سانگھار|سانگهار
سانگھارجڻ|سانگهارجڻ
سانگھارڻ|سانگهارڻ
سانگھارو|سانگهارو
سانگھر|سانگهر
سانگھرو|سانگهرو
سانگھڙ|سانگهڙ
سانگھڙو|سانگهڙو
سانگھڙي|سانگهڙي
سانگھو|سانگهو
سانگھي|سانگهي
سانگھيرو|سانگهيرو
سانگھيڙ|سانگهيڙ
سانگھيڙو|سانگهيڙو
سانگھيڙي|سانگهيڙي
سانڱاهڻ|سانڱاھڻ
سانهاري|سانھاري
سانهر|سانھر
سانهستو|سانھستو
سانهن|سانھن
سانهنجو|سانھنجو
سانهنچو|سانھنچو
سانهڻ|سانھڻ
سانهه|سانھہ
ساڻيهه|ساڻيھہ
ساڻيھھ|ساڻيھہ
ساه|ساھ
ساها|ساھا
ساهت|ساھت
ساهتا|ساھتا
ساهتي|ساھتي
ساهتيا|ساھتيا
ساهجڻ|ساھجڻ
ساهر|ساھر
ساهرا|ساھرا
ساهراڻو|ساھراڻو
ساهرو|ساھرو
ساهروٿي|ساھروٿي
ساهڙ|ساھڙ
ساهڙڪو|ساھڙڪو
ساهس|ساھس
ساهڪاڻ|ساھڪاڻ
ساهڪي|ساھڪي
ساهماڻي|ساھماڻي
ساهنگو|ساھنگو
ساهڻ|ساھڻ
ساهه|ساھ
ساهو|ساھو
ساهوال|ساھوال
ساهورو|ساھورو
ساهومو|ساھومو
ساهي|ساھي
ساهيٽو|ساھيٽو
ساهيڙپ|ساھيڙپ
ساهيڙي|ساھيڙي
ساهيلي|ساھيلي
ساھه|ساھہ
ساھھ|ساھہ
سايه|سايہ
سبزه|سبزہ
سبعه|سبعہ
سٻاجھو|سٻاجهو
سٻوجهه|سٻوجهہ
سٻوجھو|سٻوجهو
سپاهت|سپاھت
سپاهتي|سپاھتي
سپاهڪو|سپاھڪو
سپاهگري|سپاھگري
سپاهگيري|سپاھگيري
سپاهه|سپاھ
سپاهي|سپاھي
سپاهياڻو|سپاھياڻو
سپهتو|سپھتو
سپهڏي|سپھڏي
سپهر|سپھر
سپهه|سپھہ
سڀهو|سڀھو
ستائيهه|ستائيھہ
ستاره|ستارہ
ستاويهه|ستاويھہ
ستٽيهه|ستٽيھہ
سترهن|سترھن
سترهون|سترھون
ستهتر|ستھتر
ستهٺ|ستھٺ
ستهن|ستھن
ستهه|ستھہ
ستهين|ستھين
ستونجاهه|ستونجاھ
ستوهه|ستوھہ
ستوهو|ستوھو
ستيتاليهه|ستيتاليھہ
سٽهه|سٽھہ
سجاده|سجادہ
سجّاده|سجّادہ
سجاه|سجاھ
سجاهڻ|سجاھڻ
سجاهه|سجاھ
سجده|سجدہ
سجهاهه|سجهاھ
سجهه|سجهہ
سجھائتو|سجهائتو
سجھائڻ|سجهائڻ
سجھائيو|سجهائيو
سجھاتي|سجهاتي
سجھاڪو|سجهاڪو
سجھڪيون|سجهڪيون
سجھندو|سجهندو
سجھڻ|سجهڻ
سجھوڳ|سجهوڳ
سجھي|سجهي
سجھيء|سجهيء
سجيهه|سجيھہ
سجيهو|سجيھو
سڃهار|سڃھار
سڃهر|سڃھر
سڃهرو|سڃھرو
سدابهار|سدابھار
سڏوهو|سڏوھو
سراسيمه|سراسيمہ
سراه|سراھ
سراهجڻ|سراھجڻ
سراهڻ|سراھڻ
سراهي|سراھي
سربراهڪار|سربراھڪار
سربراهي|سربراھي
سرپره|سرپرہ
سرجڻهار|سرجڻھار
سرجهه|سرجهہ
سرجھڻ|سرجهڻ
سرجھو|سرجهو
سرچيهو|سرچيھو
سرمئه|سرمئہ
سرمالھي|سرمالهي
سرمه|سرمہ
سرنگهه|سرنگهه
سرنگھڙو|سرنگهڙو
سرنگھو|سرنگهو
سرنهن|سرنھن
سرنهڻ|سرنھڻ
سرنهه|سرنھہ
سرنواه|سرنواھ
سرها|سرھا
سرهائي|سرھائي
سرهاٽ|سرھاٽ
سرهاري|سرھاري
سرهاڙو|سرھاڙو
سرهال|سرھال
سرهاموٺ|سرھاموٺ
سرهاڻ|سرھاڻ
سرهاڻو|سرھاڻو
سرهاڻي|سرھاڻي
سرهجڻ|سرھجڻ
سرهل|سرھل
سرهن|سرھن
سرهندي|سرھندي
سرهنگ|سرھنگ
سرهڻ|سرھڻ
سرهڻو|سرھڻو
سرهه|سرھہ
سرهو|سرھو
سرهون|سرھون
سرهي|سرھي
سرهيا|سرھيا
سرهياري|سرھياري
سرهيال|سرھيال
سرهيل|سرھيل
سرهيو|سرھيو
سرواه|سرواھ
سرواهي|سرواھي
سروجھي|سروجهي
سروهي|سروھي
سريعالفهم|سريعالفھم
سريهن|سريھن
سريهه|سريھہ
سڙهاڪو|سڙھاڪو
سڙهڪو|سڙھڪو
سڙهڻ|سڙھڻ
سڙهه|سڙھہ
سڙهي|سڙھي
سسيهر|سسيھر
سسيهل|سسيھل
سڪڻنه|سڪڻنہ
سگهه|سگهہ
سگھائتو|سگهائتو
سگھائجڻ|سگهائجڻ
سگھائي|سگهائي
سگھاتو|سگهاتو
سگھارو|سگهارو
سگھاڻ|سگهاڻ
سگھاڻو|سگهاڻو
سگھت|سگهت
سگھتو|سگهتو
سگھرائپ|سگهرائپ
سگھرو|سگهرو
سگھڙ|سگهڙ
سگھڙائي|سگهڙائي
سگھڙو|سگهڙو
سگھڙيو|سگهڙيو
سگھڻ|سگهڻ
سگھو|سگهو
سگھوئي|سگهوئي
سگھير|سگهير
سگھيرڙپ|سگهيرڙپ
سگھيرڙو|سگهيرڙو
سگھيرو|سگهيرو
سڱوهجڻ|سڱوھجڻ
سڳهڙ|سڳھڙ
سڳهڙو|سڳھڙو
سلاڙهڻ|سلاڙھڻ
سلاڙهه|سلاڙھہ
سلاهڻ|سلاھڻ
سلاهه|سلاھ
سلجھائڻ|سلجهائڻ
سلجھائيندڙ|سلجهائيندڙ
سلجھڻ|سلجهڻ
سلطانه|سلطانہ
سلهه|سلهہ
سلھائڻ|سلهائڻ
سلھاڙ|سلهاڙ
سلھاڙجڻ|سلهاڙجڻ
سلھاڙڻ|سلهاڙڻ
سلھٽ|سلهٽ
سلھٽر|سلهٽر
سلھڙ|سلهڙ
سلھڻ|سلهڻ
سليقئه|سليقئہ
سليقه|سليقہ
سماڙهو|سماڙھو
سماهه|سماھ
سمجهه|سمجهہ
سمجھائڻ|سمجهائڻ
سمجھاڻي|سمجهاڻي
سمجھدار|سمجهدار
سمجھڻ|سمجهڻ
سمجھه|سمجھہ
سمجھھ|سمجھہ
سمجھو|سمجهو
سمجھي|سمجهي
سمنگهه|سمنگهہ
سمنگھي|سمنگهي
سمهباڻي|سمھباڻي
سمهري|سمھري
سمهڙو|سمھڙو
سمهڻون|سمھڻون
سمهه|سمهہ
سمهورو|سمھورو
سمهوري|سمھوري
سمهير|سمھير
سمھابو|سمهابو
سمھارڻ|سمهارڻ
سمھاڙو|سمهاڙو
سمھاڙي|سمهاڙي
سمھاڻي|سمهاڻي
سمھڻ|سمهڻ
سموهڻ|سموھڻ
سموهه|سموھہ
سنباهڻ|سنباھڻ
سنباهه|سنباھ
سنباهي|سنباھي
سنبهائڻ|سنبھائڻ
سنبهڻ|سنبھڻ
سنبهه|سنبھہ
سنبوهي|سنبوھي
سنڀاهه|سنڀاھ
سنجهه|سنجهہ
سنجھا|سنجها
سنجھراهه|سنجهراھ
سنجھو|سنجهو
سنجھوٽي|سنجهوٽي
سنجھورو|سنجهورو
سنجھي|سنجهي
سنجھيئي|سنجهيئي
سنجوهڻ|سنجوھڻ
سنجيهه|سنجيهہ
سنديهه|سنديھہ
سنڌيهو|سنڌيھو
سنگاهڻ|سنگاھڻ
سنگراهه|سنگراھ
سنگره|سنگرہ
سنگرهڻ|سنگرھڻ
سنگهه|سنگهہ
سنگھا|سنگها
سنگھائڻ|سنگهائڻ
سنگھائي|سنگهائي
سنگھاٽڻ|سنگهاٽڻ
سنگھار|سنگهار
سنگھارڪو|سنگهارڪو
سنگھارڪي|سنگهارڪي
سنگھارڻ|سنگهارڻ
سنگھارو|سنگهارو
سنگھاڙو|سنگهاڙو
سنگھر|سنگهر
سنگھرو|سنگهرو
سنگھري|سنگهري
سنگھريو|سنگهريو
سنگھڙ|سنگهڙ
سنگھڙڻ|سنگهڙڻ
سنگھڙي|سنگهڙي
سنگھم|سنگهم
سنگھڻ|سنگهڻ
سنگھو|سنگهو
سنگھوڙو|سنگهوڙو
سنگھي|سنگهي
سنگھيڙ|سنگهيڙ
سنهائي|سنھائي
سنهار|سنھار
سنهارو|سنھارو
سنهاري|سنھاري
سنهاڻ|سنھاڻ
سنهپ|سنھپ
سنهت|سنھت
سنهند|سنھند
سنهندو|سنھندو
سنهوئي|سنھوئي
سنهوار|سنھوار
سنهور|سنھور
سنھرو|سنهرو
سنھڙو|سنهڙو
سنھڙي|سنهڙي
سنھن|سنهن
سنيه|سنيہ
سنيهائي|سنيھائي
سنيهڙو|سنيھڙو
سنيهنو|سنيھنو
سنيهه|سنيھہ
سنيهو|سنيھو
سنيهي|سنيھي
سڻگهه|سڻگهہ
سڻگھون|سڻگهون
سڻهپ|سڻھپ
سڻهڻ|سڻھڻ
سڻهه|سڻھہ
سها|سھا
سهاء|سھاء
سهائپ|سھائپ
سهائتا|سھائتا
سهائتو|سھائتو
سهائڪ|سھائڪ
سهائڻ|سھائڻ
سهائڻو|سھائڻو
سهائو|سھائو
سهائي|سھائي
سهائيندو|سھائيندو
سهابت|سھابت
سهاتي|سھاتي
سهاجڙو|سھاجڙو
سهاجو|سھاجو
سهادو|سھادو
سهار|سھار
سهارنپوري|سھارنپوري
سهارڻ|سھارڻ
سهارو|سھارو
سهاري|سھاري
سهاڙ|سھاڙ
سهاڳ|سھاڳ
سهاڳا|سھاڳا
سهاڳڻ|سھاڳڻ
سهاڳڻيون|سھاڳڻيون
سهاڳو|سھاڳو
سهاڳي|سھاڳي
سهام|سھام
سهان|سھان
سهانجڙو|سھانجڙو
سهاندڙو|سھاندڙو
سهانگ|سھانگ
سهانگائي|سھانگائي
سهانگپ|سھانگپ
سهانگو|سھانگو
سهانو|سھانو
سهٻڏو|سھٻڏو
سهت|سھت
سهتا|سھتا
سهتائڻ|سھتائڻ
سهتڻ|سھتڻ
سهتو|سھتو
سهٽ|سھٽ
سهج|سھج
سهجاڻي|سھجاڻي
سهجر|سھجر
سهجڙو|سھجڙو
سهجڻ|سھجڻ
سهجو|سھجو
سهجي|سھجي
سهجين|سھجين
سهڃاڻ|سھڃاڻ
سهڃاڻي|سھڃاڻي
سهڄ|سھڄ
سهڄو|سھڄو
سهچار|سھچار
سهد|سھد
سهدار|سھدار
سهدو|سھدو
سهر|سھر
سهرا|سھرا
سهراب|سھراب
سهرابي|سھرابي
سهرات|سھرات
سهرو|سھرو
سهروردي|سھروردي
سهرياڻي|سھرياڻي
سهڙ|سھڙ
سهڙا|سھڙا
سهڙائڻ|سھڙائڻ
سهڙڪي|سھڙڪي
سهڙڻ|سھڙڻ
سهڙي|سھڙي
سهس|سھس
سهسائڻ|سھسائڻ
سهسيرڙو|سھسيرڙو
سهسين|سھسين
سهکو|سھکو
سهڪار|سھڪار
سهڪجي|سھڪجي
سهڪڙو|سھڪڙو
سهڪڻ|سھڪڻ
سهڪو|سھڪو
سهڪي|سھڪي
سهگڙو|سھگڙو
سهڳ|سھڳ
سهل|سھل
سهلڻ|سھلڻ
سهم|سھم
سهما|سھما
سهمائڻ|سھمائڻ
سهماڻي|سھماڻي
سهمجڻ|سھمجڻ
سهمڻ|سھمڻ
سهمو|سھمو
سهميل|سھميل
سهن|سھن
سهنج|سھنج
سهنجا|سھنجا
سهنجائپ|سھنجائپ
سهنجائي|سھنجائي
سهنجو|سھنجو
سهنڃ|سھنڃ
سهند|سھند
سهندڙو|سھندڙو
سهندو|سھندو
سهنڌ|سھنڌ
سهنگائي|سھنگائي
سهنگو|سھنگو
سهڻ|سھڻ
سهڻا|سھڻا
سهڻائي|سھڻائي
سهڻو|سھڻو
سهڻي|سھڻي
سهڻيءَ|سھڻيءَ
سهه|سھہ
سهو|سھو
سهوا|سھوا
سهوالقلم|سھوالقلم
سهواڻ|سھواڻ
سهول|سھول
سهولت|سھولت
سهونجي|سھونجي
سهي|سھي
سهيپ|سھيپ
سهيپو|سھيپو
سهيتائڻ|سھيتائڻ
سهيتڻ|سھيتڻ
سهيجا|سھيجا
سهيجاڻي|سھيجاڻي
سهيرل|سھيرل
سهيرو|سھيرو
سهيڙ|سھيڙ
سهيڙجڻ|سھيڙجڻ
سهيڙڻ|سھيڙڻ
سهيڙو|سھيڙو
سهيس|سھيس
سهيل|سھيل
سهيلا|سھيلا
سهيلائي|سھيلائي
سهيلپ|سھيلپ
سهيلو|سھيلو
سهيلي|سھيلي
سهيلين|سھيلين
سهيند|سھيند
سهيندي|سھيندي
سهينديء|سھينديء
سهيڻو|سھيڻو
سهيو|سھيو
سواهرو|سواھرو
سوٽهڙ|سوٽھڙ
سوٽهڙڪو|سوٽھڙڪو
سوٽهل|سوٽھل
سوجھا|سوجها
سوجھائڻ|سوجهائڻ
سوجھاڪو|سوجهاڪو
سوجھاڳو|سوجهاڳو
سوجھرو|سوجهرو
سوجھڙ|سوجهڙ
سوجھڙباراني|سوجهڙباراني
سوجھڻ|سوجهڻ
سوجھھ|سوجهہ
سوجھو|سوجهو
سوجھي|سوجهي
سوخته|سوختہ
سورانگھڻ|سورانگهڻ
سورھيھ|سورهيہ
سورينگھھ|سورينگهہ
سوڙاھھ|سوڙاه
سوڙھا|سوڙها
سوڙھاڳ|سوڙهاڳ
سوڙھڻ|سوڙهڻ
سوڙھھ|سوڙه
سوڙھو|سوڙهو
سوڙھي|سوڙهي
سوڪهڙو|سوڪھڙو
سوڪهڙي|سوڪھڙي
سوگھائي|سوگهائي
سوگھارو|سوگهارو
سوگھاڻ|سوگهاڻ
سوگھھ|سوگهہ
سوگھو|سوگهو
سولھڙ|سولهڙ
سولھي|سولهي
سومھڻي|سومهڻي
سومھياڻي|سومهياڻي
سونجھڙو|سونجهڙو
سونجھڻ|سونجهڻ
سونجھڻو|سونجهڻو
سونجھھ|سونجهہ
سونجھو|سونجهو
سونجھيو|سونجهيو
سونگھڻ|سونگهڻ
سونگھي|سونگهي
سونهائڻ|سونھائڻ
سونهائي|سونھائي
سونهارو|سونھارو
سونهاري|سونھاري
سونهالو|سونھالو
سونهپ|سونھپ
سونهر|سونھر
سونهري|سونھري
سونهڙا|سونھڙا
سونهن|سونھن
سونهڻ|سونھڻ
سونهون|سونھون
سونهي|سونھي
سونهيرا|سونھيرا
سونهيري|سونھيري
سونهين|سونھين
سونهيون|سونھيون
سونواهه|سونواھ
سوهئڻ|سوھئڻ
سوهائڻ|سوھائڻ
سوهاتو|سوھاتو
سوهارو|سوھارو
سوهان|سوھان
سوهرو|سوھرو
سوهڙو|سوھڙو
سوهڪي|سوھڪي
سوهم|سوھم
سوهمو|سوھمو
سوهنجو|سوھنجو
سوهڻ|سوھڻ
سوهڻون|سوھڻون
سوهو|سوھو
سوهي|سوھي
سوهيتر|سوھيتر
سوهيرو|سوھيرو
سوهيڙو|سوھيڙو
سويرڙاهون|سويرڙاھون
سويرهون|سويرھون
سويساهو|سويساھو
سويلاهون|سويلاھون
سياره|سيارہ
سياه|سياھ
سياهان|سياھان
سياهه|سياھ
سياهو|سياھو
سياهي|سياھي
سيپاره|سيپارہ
سيجاه|سيجاھ
سيجاهرو|سيجاھرو
سيجھرو|سيجهرو
سيڃاهو|سيڃاھو
سيڃهه|سيڃھہ
سيڄاهو|سيڄاھو
سيراهه|سيراھ
سيراهي|سيراھي
سيرهڻ|سيرھڻ
سيرهه|سيرھ
سيڙاهي|سيڙاھي
سيڙھ|سيڙه
سيڙھاني|سيڙهاني
سيڙھاڻي|سيڙهاڻي
سيڙھجي|سيڙهجي
سيڙھڪا|سيڙهڪا
سيڙھڻ|سيڙهڻ
سيڙھھ|سيڙه
سيڙھو|سيڙهو
سيڙھي|سيڙهي
سيڙھيار|سيڙهيار
سيگھھ|سيگهہ
سيگھو|سيگهو
سيگھي|سيگهي
سيلھڻ|سيلهڻ
سيلھھ|سيلهہ
سيلھو|سيلهو
سيلھور|سيلهور
سيلھورڻ|سيلهورڻ
سيلھوڙو|سيلهوڙو
سيلھي|سيلهي
سينگھاري|سينگهاري
سينهال|سينھال
سينهڙا|سينھڙا
سينهن|سينھن
سينهند|سينھند
سينهندو|سينھندو
سينهندي|سينھندي
سينهه|سينھہ
سينهو|سينھو
سينهور|سينھور
سينهوري|سينھوري
سينهوڙو|سينھوڙو
سينهون|سينھون
سيڻاهه|سيڻاھ
سيڻاهيو|سيڻاھيو
سيڻهڏي|سيڻھڏي
سيڻهه|سيڻهہ
سيهالف|سيھالف
سيهراج|سيھراج
سيهري|سيھري
سيهڙ|سيھڙ
سيهڙا|سيھڙا
سيهڙو|سيھڙو
سيهو|سيھو
سيوھڻ|سيوهڻ
شائبه|شائبہ
شانهر|شانھر
شانهريل|شانھريل
شانهڙي|شانھڙي
شاهانه|شاھانہ
شاهاڻو|شاھاڻو
شاهاڻي|شاھاڻي
شاهباز|شاھباز
شاهبوم|شاھبوم
شاهپئي|شاھپئي
شاهپور|شاھپور
شاهترو|شاھترو
شاهد|شاھد
شاهداڻو|شاھداڻو
شاهدي|شاھدي
شاهزادو|شاھزادو
شاهزادي|شاھزادي
شاهڪار|شاھڪار
شاهڪپور|شاھڪپور
شاهل|شاھل
شاهنامو|شاھنامو
شاهنشاهه|شاھنشاھ
شاهنشاهي|شاھنشاھي
شاهه|شاھہ
شاهو|شاھو
شاهواڻي|شاھواڻي
شاهوڙ|شاھوڙ
شاهوڪ|شاھوڪ
شاهوڪار|شاھوڪار
شاهوڪاري|شاھوڪاري
شاهول|شاھول
شاهي|شاھي
شاهين|شاھين
شاهينگ|شاھينگ
شاھھ|شاھہ
شباهت|شباھت
شبه|شبہ
شبهه|شبھہ
شبهو|شبھو
شبيه|شبيھ
شتاه|شتاھ
شجراه|شجراھ
شجراهه|شجراھہ
شده|شدہ
شرطه|شرطہ
شرطيہ|شرطيه
شرنهه|شرنھہ
شرواه|شرواھ
شريفه|شريفہ
شسته|شستہ
ششماهي|ششماھي
شعبده|شعبدہ
شعله|شعلہ
شفعه|شفعہ
شفويه|شفويہ
شڪرانه|شڪرانہ
شڪردهن|شڪردھن
شڪسته|شڪستہ
شڪوه|شڪوہ
شگفته|شگفتہ
شنهار|شنھار
شنهارجي|شنھارجي
شنهاري|شنھاري
شنيده|شنيدہ
شه|شہ
شهاب|شھاب
شهابي|شھابي
شهادت|شھادت
شهامت|شھامت
شهاڻي|شھاڻي
شهبارڪاڻي|شھبارڪاڻي
شهباز|شھباز
شهبيگ|شھبيگ
شهپر|شھپر
شهتا|شھتا
شهتارو|شھتارو
شهتر|شھتر
شهتوت|شھتوت
شهد|شھد
شهداء|شھداء
شهداد|شھداد
شهدادپور|شھدادپور
شهدو|شھدو
شهدي|شھدي
شهر|شھر
شهرت|شھرت
شهرتو|شھرتو
شهرو|شھرو
شهري|شھري
شهريار|شھريار
شهريت|شھريت
شهزادو|شھزادو
شهزوري|شھزوري
شهڪ|شھڪ
شهڪر|شھڪر
شهگوش|شھگوش
شهل|شھل
شهلي|شھلي
شهمال|شھمال
شهمڻ|شھمڻ
شهمير|شھمير
شهمينگ|شھمينگ
شهنائي|شھنائي
شهنشاه|شھنشاه
شهنشاهي|شھنشاھي
شهننگ|شھننگ
شهڻا|شھڻا
شهه|شهہ
شهواني|شھواني
شهواڻي|شھواڻي
شهوت|شھوت
شهوتي|شھوتي
شهوٽ|شھوٽ
شهوٽائتو|شھوٽائتو
شهوٽو|شھوٽو
شهود|شھود
شهور|شھور
شهول|شھول
شهونگ|شھونگ
شهوڻي|شھوڻي
شهيجا|شھيجا
شهيد|شھيد
شهيدان|شھيدان
شهيدين|شھيدين
شهير|شھير
شهين|شھين
شوريده|شوريدہ
شوهر|شوھر
شيرازه|شيرازہ
شيرشاه|شيرشاہ
شيره|شيرہ
شيرواه|شيرواہ
شينهڙا|شينھڙا
شينهڙو|شينھڙو
شينهن|شينھن
شينهڻ|شينھڻ
شيهو|شيھو
شيهي|شيھي
صادقه|صادقہ
صاهرا|صاھرا
صحابه|صحابہ
صخرهه|صخرہ
صدها|صدھا
صه|صہ
صهبا|صھبا
ضابطه|ضابطہ
ضعيفه|ضعيفہ
طاهر|طاھر
طاهري|طاھري
طعنه|طعنہ
طهارت|طھارت
طهر|طھر
طهرت|طھرت
طهرڻ|طھرڻ
طهري|طھري
طهور|طھور
طهورا|طھورا
طياره|طيارہ
طيبه|طيبہ
ظاهر|ظاھر
ظاهربين|ظاھربين
ظاهردار|ظاھردار
ظاهرداري|ظاھرداري
ظاهري|ظاھري
ظهر|ظھر
ظهور|ظھور
ظهورو|ظھورو
ظهير|ظھير
ظهيري|ظھيري
عاجزه|عاجزہ
عارفانه|عارفانہ
عبادتگاهه|عبادتگاھ
عبهر|عبھر
عذرخواهي|عذرخواھي
عشره|عشرہ
عشقه|عشقہ
عشوه|عشوہ
عقده|عقدہ
علاوه|علاوہ
عليه|عليہ
عليواهڻ|عليواھڻ
عمامه|عمامہ
عهد|عھد
عهدشڪني|عھدشڪني
عهدنامو|عھدنامو
عهدو|عھدو
عهدي|عھدي
عهديدار|عھديدار
عينلهر|عينلھر
غائبانه|غائبانہ
غازه|غازہ
غرضانه|غرضانہ
غلطفهمي|غلطفھمي
غله|غلہ
غنڊه|غنڊہ
فاتحه|فاتحہ
فاخته|فاختہ
فاخره|فاخرہ
فادزهر|فادزھر
فاصله|فاصلہ
فاطمه|فاطمه
فاقه|فاقہ
فتوهي|فتوھي
فديه|فديہ
فراهم|فراھم
فربه|فربہ
فرخنده|فرخندہ
فرزانه|فرزانہ
فرسوده|فرسودہ
فرهاد|فرھاد
فرهنگ|فرھنگ
فرهي|فرھي
فريضه|فريضہ
فريفته|فريفتہ
فعليه|فعليہ
فقه|فقہ
فقهو|فقھو
فقيهه|فقيھہ
فلسفه|فلسفہ
فهار|فھار
فهارو|فھارو
فهرست|فھرست
فهم|فھم
فهمائش|فھمائش
فهمي|فھمي
فهميدو|فھميدو
فهميون|فھميون
فهيم|فھيم
فوجگاهه|فوجگاه
فينگھوريا|فينگهوريا
فيه|فيہ
ڦاراهو|ڦاراھو
ڦارهڏي|ڦارھڏي
ڦارهو|ڦارھو
ڦارهون|ڦارھون
ڦارهيو|ڦارھيو
ڦاروهو|ڦاروھو
ڦاڙھا|ڦاڙها
ڦاڙھو|ڦاڙهو
ڦاڙھيارو|ڦاڙهيارو
ڦالھو|ڦالهو
ڦانجھروٽو|ڦانجهروٽو
ڦانجھو|ڦانجهو
ڦانگھو|ڦانگهو
ڦانهن|ڦانھن
ڦاها|ڦاھا
ڦاهو|ڦاھو
ڦاهي|ڦاھي
ڦتهي|ڦتھي
ڦتوهل|ڦتوھل
ڦٽهڙو|ڦٽھڙو
ڦٽوهڙ|ڦٽوھڙ
ڦديهه|ڦديھہ
ڦڏهڙي|ڦڏھڙي
ڦراهو|ڦراھو
ڦرها|ڦرھا
ڦرهار|ڦرھار
ڦرهاروڙڻ|ڦرھاروڙڻ
ڦرهر|ڦرھر
ڦرهڙي|ڦرھڙي
ڦرهه|ڦرھ
ڦرهو|ڦرھو
ڦرهوڙي|ڦرھوڙي
ڦرهي|ڦرھي
ڦرهيڙي|ڦرھيڙي
ڦرهيو|ڦرھيو
ڦريلهجڻ|ڦريلھجڻ
ڦڙهٿو|ڦڙھٿو
ڦڙهڻ|ڦڙھڻ
ڦڙهه|ڦڙهہ
ڦڙھو|ڦڙهو
ڦڙيهه|ڦڙيھہ
ڦڪانجھرو|ڦڪانجهرو
ڦڪانجھو|ڦڪانجهو
ڦڳهين|ڦڳھين
ڦلھائي|ڦلهائي
ڦلھار|ڦلهار
ڦلھارجڻ|ڦلهارجڻ
ڦلھڏي|ڦلهڏي
ڦلھڏيون|ڦلهڏيون
ڦلھڙو|ڦلهڙو
ڦلھو|ڦلهو
ڦلھيار|ڦلهيار
ڦلھير|ڦلهير
ڦلھيرڻ|ڦلهيرڻ
ڦلواهڻ|ڦلواھڻ
ڦلوهو|ڦلوھو
ڦليهر|ڦليھر
ڦنجهه|ڦنجهہ
ڦنجھڻ|ڦنجهڻ
ڦنجھو|ڦنجهو
ڦنجھون|ڦنجهون
ڦنگهه|ڦنگهہ
ڦنگھڻ|ڦنگهڻ
ڦنگھو|ڦنگهو
ڦنگھي|ڦنگهي
ڦڻهه|ڦڻهہ
ڦڻيهاري|ڦڻيھاري
ڦهائي|ڦھائي
ڦهار|ڦھار
ڦهارو|ڦھارو
ڦهڪا|ڦھڪا
ڦهڪاء|ڦھڪاء
ڦهڪائڻ|ڦھڪائڻ
ڦهڪائي|ڦھڪائي
ڦهڪاٽ|ڦھڪاٽ
ڦهڪارو|ڦھڪارو
ڦهڪڻ|ڦھڪڻ
ڦهڪڻو|ڦھڪڻو
ڦهڪو|ڦھڪو
ڦهل|ڦھل
ڦهلاء|ڦھلاء
ڦهلائڻ|ڦھلائڻ
ڦهلڻ|ڦھلڻ
ڦهنگ|ڦھنگ
ڦهنگر|ڦھنگر
ڦهنگڻ|ڦھنگڻ
ڦهنگون|ڦھنگون
ڦهي|ڦھي
ڦهيار|ڦھيار
ڦهيارو|ڦھيارو
ڦهياري|ڦھياري
ڦهيڙ|ڦھيڙ
ڦهيون|ڦھيون
ڦوٽهڙو|ڦوٽھڙو
ڦوٽهڙي|ڦوٽھڙي
ڦوڙهه|ڦوڙہ
ڦوڙهو|ڦوڙهو
ڦوڙھاٺي|ڦوڙهاٺي
ڦوڳهڙو|ڦوڳھڙو
ڦولهه|ڦولهہ
ڦولھا|ڦولها
ڦولھارڻ|ڦولهارڻ
ڦولھر|ڦولهر
ڦولھڙي|ڦولهڙي
ڦولھڻ|ڦولهڻ
ڦونگھارو|ڦونگهارو
ڦوهارو|ڦوھارو
ڦوهٽو|ڦوھٽو
ڦوهر|ڦوھر
ڦوهرا|ڦوھرا
ڦوهڙ|ڦوھڙ
ڦوهڙو|ڦوھڙو
ڦوهڻ|ڦوھڻ
ڦوهڻي|ڦوھڻي
ڦوهه|ڦوھ
ڦوهياري|ڦوھياري
ڦيٽاهين|ڦيٽاھين
ڦيٽهڙ|ڦيٽھڙ
ڦيٽهڙو|ڦيٽھڙو
ڦيٿڙهه|ڦيٿڙہ
ڦيرگھير|ڦيرگهير
ڦيڙھو|ڦيڙهو
ڦيلھو|ڦيلهو
ڦيلھي|ڦيلهي
ڦيلھيء|ڦيلهيء
ڦينجھاڙي|ڦينجهاڙي
ڦينجھو|ڦينجهو
ڦينگھار|ڦينگهار
ڦيڻاهي|ڦيڻاھي
ڦيهڻ|ڦيھڻ
ڦيهه|ڦيھہ
ڦيهون|ڦيھون
قاروره|قارورھ
قاعده|قاعدہ
قافله|قافلہ
قاهرو|قاهرو
قبله|قبلہ
قحبه|قحبہ
قديمه|قديمہ
قعده|قعدہ
قلئه|قلئہ
قلندرشهباز|قلندرشھباز
قليه|قليہ
قهار|قھار
قهاري|قھاري
قهر|قھر
قهري|قھري
قهقه|قھقھہ
قهقهو|قھقھو
قهوه|قھوہ
قهوو|قھوو
قهوي|قھوي
قهيري|قھيري
قيافه|قيافہ
کئه|کئہ
کاٻهه|کاٻھہ
کاراهو|کاراھو
کاڙهو|کاڙھو
کاڪاهو|کاڪاھو
کانگھار|کانگهار
کانگھارڻ|کانگهارڻ
کانگھارو|کانگهارو
کانگھاري|کانگهاري
کانگھو|کانگهو
کانهار|کانھار
کانهر|کانھر
کاهر|کاھر
کاهڙ|کاھڙ
کاهه|کاھ
کاهو|کاھو
کاهوڙائڻ|کاھوڙائڻ
کاهوڙائي|کاھوڙائي
کاهوڙائيون|کاھوڙائيون
کاهوڙجڻ|کاھوڙجڻ
کاهوڙو|کاھوڙو
کاهوڙي|کاھوڙي
کاهوڙيان|کاھوڙيان
کاهي|کاھي
کاهيار|کاھيار
کاهيڙي|کاھيڙي
کٽڻهار|کٽڻھار
کٽڻهارو|کٽڻھارو
کٽهڙي|کٽھڙي
کٿيهر|کٿيھر
کجھائڻ|کجهائڻ
کڏکوهي|کڏکوھي
کڏهر|کڏھر
کڏهرو|کڏھرو
کڏهري|کڏھري
کراهو|کراھو
کرهن|کرھن
کرهه|کرھہ
کرهو|کرھو
کڙاهه|کڙاھ
کسٻيجاهه|کسٻيجاھ
ککرهاه|ککرھاہ
کنجھڙ|کنجهڙ
کنجھڻ|کنجهڻ
کنجھو|کنجهو
کنڊهر|کنڊھر
کنڊيهار|کنڊيھار
کنڌوهي|کنڌوھي
کنگھائي|کنگهائي
کنگھار|کنگهار
کنگھارڻ|کنگهارڻ
کنگھر|کنگهر
کنگھڪارڻ|کنگهڪارڻ
کنگھڻ|کنگهڻ
کنگھه|کنگهہ
کنگھو|کنگهو
کنگھي|کنگهي
کنھا|کنها
کنھائڻ|کنهائڻ
کنھار|کنهار
کنھارڻ|کنهارڻ
کنھاڙڻ|کنهاڙڻ
کنھن|کنهن
کنھڻ|کنهڻ
کنھڻي|کنهڻي
کنھواري|کنهواري
کنھور|کنهور
کنھي|کنهي
کڻھار|کڻهار
کڻھيڍي|کڻهيڍي
کڻيجاهه|کڻيجاھہ
کهائڻ|کھائڻ
کهاڏو|کھاڏو
کهاڙو|کھاڙو
کهاڻو|کھاڻو
کهاوڙ|کھاوڙ
کهٽ|کھٽ
کهجڻ|کھجڻ
کهجي|کھجي
کهر|کھر
کهرائي|کھرائي
کهراڻ|کھراڻ
کهرو|کھرو
کهري|کھري
کهڙا|کھڙا
کهڙو|کھڙو
کهن|کھن
کهنبا|کھنبا
کهنبائي|کھنبائي
کهنباٽي|کھنباٽي
کهنبڙا|کھنبڙا
کهنبڙي|کھنبڙي
کهنبو|کھنبو
کهنبي|کھنبي
کهنڀڙي|کھنڀڙي
کهڻ|کھڻ
کهو|کھو
کهوالي|کھوالي
کهور|کھور
کهي|کھي
کهياتو|کھياتو
کهيد|کھيد
کهيري|کھيري
کهيڙو|کھيڙو
کهيڙي|کھيڙي
کهيل|کھيل
کهيو|کھيو
کھھ|کھہ
کوٽهڙو|کوٽھڙو
کولهڙ|کولھڙ
کونگھرو|کونگهرو
کوه|کوھ
کوهاڏو|کوھاڏو
کوهار|کوھار
کوهارا|کوھارا
کوهاڻو|کوھاڻو
کوهر|کوھر
کوهرو|کوھرو
کوهلي|کوھلي
کوهن|کوھن
کوهڻ|کوھڻ
کوهه|کوھہ
کوهو|کوھو
کوهي|کوھي
کوهيو|کوھيو
کوھھ|کوھہ
کيجھو|کيجهو
کيرجھڻي|کيرجهڻي
کيلھو|کيلهو
کينجھو|کينجهو
کينگھو|کينگهو
کينگھي|کينگهي
کينھو|کينهو
کينھوڙو|کينهوڙو
کينھون|کينهون
کيهان|کيھان
کيهه|کيھہ
کيهوار|کيھوار
ڪئه|ڪئہ
ڪابه|ڪابہ
ڪاٻهه|ڪاٻھہ
ڪاپاهو|ڪاپاھو
ڪاپاهي|ڪاپاھي
ڪاتهين|ڪاتھين
ڪاٺڳڙه|ڪاٺڳڙہ
ڪاٿنهن|ڪاٿنھن
ڪاٿهين|ڪاٿھين
ڪاجھر|ڪاجهر
ڪاجھري|ڪاجهري
ڪاڏانهن|ڪاڏانھن
ڪاڏانهين|ڪاڏانھين
ڪاڏنهن|ڪاڏنھن
ڪاڏنهون|ڪاڏنھون
ڪاراجھو|ڪاراجهو
ڪارانجھڙو|ڪارانجهڙو
ڪارانجھڙي|ڪارانجهڙي
ڪاراهو|ڪاراھو
ڪاراهي|ڪاراھي
ڪارتهو|ڪارتھو
ڪارتهي|ڪارتھي
ڪارتوهو|ڪارتوھو
ڪارمنهائي|ڪارمنھائي
ڪارمنهون|ڪارمنھون
ڪارنگھو|ڪارنگهو
ڪارنهن|ڪارنھن
ڪارهن|ڪارھن
ڪارهندو|ڪارھندو
ڪارهون|ڪارھون
ڪارهين|ڪارھين
ڪارهيو|ڪارھيو
ڪارونجھر|ڪارونجهر
ڪاروهر|ڪاروھر
ڪارينگھو|ڪارينگهو
ڪاريه|ڪاريہ
ڪاريهر|ڪاريھر
ڪاڙهه|ڪاڙہ
ڪاڙھا|ڪاڙها
ڪاڙھائتو|ڪاڙهائتو
ڪاڙھڻ|ڪاڙهڻ
ڪاڙھو|ڪاڙهو
ڪاڪاهو|ڪاڪاھو
ڪالهه|ڪالهہ
ڪالھه|ڪالهہ
ڪالھھ|ڪالھہ
ڪالھو|ڪالهو
ڪالھوڙي|ڪالهوڙي
ڪالھوڪو|ڪالهوڪو
ڪالھوڻئا|ڪالهوڻئا
ڪالھوڻو|ڪالهوڻو
ڪالھوڻي|ڪالهوڻي
ڪامنهه|ڪامنھہ
ڪامڻھوري|ڪامڻهوري
ڪامهن|ڪامھن
ڪامھو|ڪامهو
ڪامھي|ڪامهي
ڪامھين|ڪامهين
ڪاموه|ڪاموھ
ڪاموهي|ڪاموھي
ڪانجھاٽي|ڪانجهاٽي
ڪانجھڻ|ڪانجهڻ
ڪانجھو|ڪانجهو
ڪانجھي|ڪانجهي
ڪانڪهه|ڪانڪھہ
ڪانگهه|ڪانگهہ
ڪانگھارا|ڪانگهارا
ڪانگھارو|ڪانگهارو
ڪانگھاري|ڪانگهاري
ڪانمانهه|ڪانمانھہ
ڪانه|ڪانہ
ڪانهر|ڪانھر
ڪانهرو|ڪانھرو
ڪانهري|ڪانھري
ڪانهلائي|ڪانھلائي
ڪانهلو|ڪانھلو
ڪانهن|ڪانھن
ڪانهه|ڪانھہ
ڪانهون|ڪانھون
ڪانهياري|ڪانھياري
ڪانهيرو|ڪانھيرو
ڪانهيڪي|ڪانھيڪي
ڪانهين|ڪانھين
ڪانهيو|ڪانھيو
ڪانھي|ڪانهي
ڪانوجھرو|ڪانوجهرو
ڪانيهر|ڪانيھر
ڪانيهو|ڪانيھو
ڪاڻاهه|ڪاڻاھہ
ڪاڻھيار|ڪاڻهيار
ڪاهرو|ڪاھرو
ڪاهري|ڪاھري
ڪاهڪي|ڪاھڪي
ڪاهل|ڪاھل
ڪاهلپ|ڪاھلپ
ڪاهلپڻ|ڪاھلپڻ
ڪاهلي|ڪاھلي
ڪاهه|ڪاھ
ڪاهو|ڪاھو
ڪاهوء|ڪاھوء
ڪاهوٽي|ڪاھوٽي
ڪاهوجي|ڪاھوجي
ڪاهوري|ڪاھوري
ڪاهيا|ڪاھيا
ڪاهيجا|ڪاھيجا
ڪاهين|ڪاھين
ڪٻهڙي|ڪٻھڙي
ڪٻهه|ڪٻھہ
ڪٻوهڙي|ڪٻوھڙي
ڪٻوهو|ڪٻوھو
ڪپاهه|ڪپاھ
ڪپهه|ڪپھہ
ڪپوهي|ڪپوھي
ڪپيهل|ڪپيھل
ڪتهڙ|ڪتھڙ
ڪتهه|ڪتھہ
ڪتهين|ڪتھين
ڪٽاهه|ڪٽاھ
ڪٽهڙ|ڪٽھڙ
ڪٽهڙو|ڪٽھڙو
ڪٽوهر|ڪٽوھر
ڪٽوهڙ|ڪٽوھڙ
ڪٿانهين|ڪٿانھين
ڪٿهن|ڪٿھن
ڪٿهين|ڪٿھين
ڪجفهم|ڪجفھم
ڪجهه|ڪجهہ
ڪُجهه|ڪُجهہ
ڪجھا|ڪجها
ڪجھڙ|ڪجهڙ
ڪجھه|ڪجهہ
ڪجھھ|ڪجھ
ڪڄھه|ڪڄهہ
ڪچهري|ڪچھري
ڪچهريء|ڪچھريء
ڪچهلا|ڪچھلا
ڪده|ڪدہ
ڪدهه|ڪدہ
ڪڏهاڪر|ڪڏھاڪر
ڪڏهاڪو|ڪڏھاڪو
ڪڏهڪو|ڪڏھڪو
ڪڏهن|ڪڏھن
ڪڏهوڪو|ڪڏھوڪو
ڪڏهوڻڪو|ڪڏھوڻڪو
ڪڏهوڻو|ڪڏھوڻو
ڪڏهين|ڪڏھين
ڪراجهه|ڪراجهہ
ڪرانجهه|ڪرانجهہ
ڪراهت|ڪراھت
ڪراهه|ڪراھ
ڪراهي|ڪراھي
ڪرجهه|ڪرجهہ
ڪرشمه|ڪرشمہ
ڪرلاهو|ڪرلاھو
ڪرناه|ڪرناھ
ڪرنجھه|ڪرنجهہ
ڪرنجھو|ڪرنجهو
ڪرنگھر|ڪرنگهر
ڪرنگھه|ڪرنگهہ
ڪرنگھو|ڪرنگهو
ڪرنهن|ڪرنھن
ڪره|ڪرھ
ڪرهائي|ڪرھائي
ڪرهر|ڪرھر
ڪرهل|ڪرھل
ڪرهن|ڪرھن
ڪرهڻ|ڪرھڻ
ڪرهه|ڪرھ
ڪرهو|ڪرھو
ڪرهوڙ|ڪرھوڙ
ڪرهي|ڪرھي
ڪرونجھي|ڪرونجهي
ڪريجاه|ڪريجاھ
ڪريهر|ڪريھر
ڪڙاهه|ڪڙاھ
ڪڙاهو|ڪڙاھو
ڪڙاهيئو|ڪڙاھيئو
ڪڙڳھه|ڪڙڳهہ
ڪڙهه|ڪڙه
ڪڙھاٽ|ڪڙهاٽ
ڪڙھڻ|ڪڙهڻ
ڪڙھو|ڪڙهو
ڪڙھولي|ڪڙهولي
ڪڙھي|ڪڙهي
ڪڙھير|ڪڙهير
ڪڙھيون|ڪڙهيون
ڪڙواهه|ڪڙواھ
ڪسجهه|ڪسجهہ
ڪسجھي|ڪسجهي
ڪسره|ڪسرہ
ڪسهاتو|ڪسھاتو
ڪشاهيگ|ڪشاھيگ
ڪشهوغ|ڪشھوغ
ڪشيده|ڪشيدہ
ڪڪهه|ڪڪھہ
ڪڪوهه|ڪڪوھ
ڪگھري|ڪگهري
ڪلئه|ڪلئہ
ڪلانجهه|ڪلانجهہ
ڪلاه|ڪلاھ
ڪلاهدان|ڪلاھدان
ڪلاهه|ڪلاھ
ڪلگھو|ڪلگهو
ڪلنگھو|ڪلنگهو
ڪلهه|ڪلهہ
ڪلھا|ڪلها
ڪلھان|ڪلهان
ڪلھٽي|ڪلهٽي
ڪلھن|ڪلهن
ڪلھنئون|ڪلهنئون
ڪلھننئان|ڪلهننئان
ڪلھه|ڪلھہ
ڪلھو|ڪلهو
ڪلھوڙا|ڪلهوڙا
ڪلھوڙڪي|ڪلهوڙڪي
ڪلھوڙو|ڪلهوڙو
ڪلھوڪو|ڪلهوڪو
ڪلھوڪي|ڪلهوڪي
ڪلھوڻو|ڪلهوڻو
ڪلھي|ڪلهي
ڪلھيرو|ڪلهيرو
ڪلھيري|ڪلهيري
ڪليه|ڪليہ
ڪماڙھو|ڪماڙهو
ڪماڻھو|ڪماڻهو
ڪماهي|ڪماھي
ڪمھري|ڪمهري
ڪمھڪوڻ|ڪمهڪوڻ
ڪمھلائي|ڪمهلائي
ڪمھلو|ڪمهلو
ڪمھوڙ|ڪمهوڙ
ڪميجھل|ڪميجهل
ڪناره|ڪنارہ
ڪنباهي|ڪنباھي
ڪنجهه|ڪنجهہ
ڪنجهو|ڪنجهو
ڪنجھاوٽي|ڪنجهاوٽي
ڪنجھر|ڪنجهر
ڪنجھڙاٽ|ڪنجهڙاٽ
ڪنجھڪار|ڪنجهڪار
ڪنجھڪر|ڪنجهڪر
ڪنجھڪڻ|ڪنجهڪڻ
ڪنجھڪو|ڪنجهڪو
ڪنجھڪيو|ڪنجهڪيو
ڪنجھڻ|ڪنجهڻ
ڪنجھڻي|ڪنجهڻي
ڪنجھي|ڪنجهي
ڪنڊراهه|ڪنڊراھ
ڪنڌاهه|ڪنڌاھ
ڪنگھل|ڪنگهل
ڪنگھو|ڪنگهو
ڪنگھي|ڪنگهي
ڪنهن|ڪنھن
ڪنهنباز|ڪنھنباز
ڪنهه|ڪنهہ
ڪنهون|ڪنھون
ڪنهيرو|ڪنھيرو
ڪنھاڙ|ڪنهاڙ
ڪنھڙ|ڪنهڙ
ڪڻاهه|ڪڻاھ
ڪڻاهو|ڪڻاھو
ڪڻاهي|ڪڻاھي
ڪڻگھو|ڪڻگهو
ڪڻھار|ڪڻهار
ڪڻھو|ڪڻهو
ڪڻھي|ڪڻهي
ڪهاء|ڪھاء
ڪهائڻ|ڪھائڻ
ڪهائو|ڪھائو
ڪهائي|ڪھائي
ڪهات|ڪھات
ڪهار|ڪھار
ڪهارو|ڪھارو
ڪهاڙ|ڪھاڙ
ڪهاڙا|ڪھاڙا
ڪهاڙو|ڪھاڙو
ڪهاڙيء|ڪھاڙيء
ڪهاڙين|ڪھاڙين
ڪهاڙيو|ڪھاڙيو
ڪهاڻـي|ڪھاڻـي
ڪهاڻي|ڪھاڻي
ڪهاوت|ڪھاوت
ڪهبان|ڪھبان
ڪهبر|ڪھبر
ڪهت|ڪھت
ڪهڄر|ڪھڄر
ڪهر|ڪھر
ڪهرائي|ڪھرائي
ڪهربا|ڪھربا
ڪهرڪي|ڪھرڪي
ڪهرو|ڪھرو
ڪهروڙو|ڪھروڙو
ڪهري|ڪھري
ڪهڙ|ڪھڙ
ڪهڙو|ڪھڙو
ڪهڙي|ڪھڙي
ڪهف|ڪھف
ڪهڪ|ڪھڪ
ڪهڪاء|ڪھڪاء
ڪهڪائڻ|ڪھڪائڻ
ڪهڪاٽ|ڪھڪاٽ
ڪهڪشان|ڪھڪشان
ڪهڪڻ|ڪھڪڻ
ڪهڪي|ڪھڪي
ڪهگل|ڪھگل
ڪهل|ڪھل
ڪهلجڻ|ڪھلجڻ
ڪهلو|ڪھلو
ڪهليو|ڪھليو
ڪهم|ڪھم
ڪهمڪ|ڪھمڪ
ڪهن|ڪھن
ڪهنائي|ڪھنائي
ڪهنانگ|ڪھنانگ
ڪهنگ|ڪھنگ
ڪهنو|ڪھنو
ڪهني|ڪھني
ڪهڻ|ڪھڻ
ڪهڻو|ڪھڻو
ڪهڻي|ڪھڻي
ڪهه|ڪھہ
ڪهو|ڪھو
ڪهوت|ڪھوت
ڪهول|ڪھول
ڪهون|ڪھون
ڪهي|ڪھي
ڪهيا|ڪھيا
ڪهير|ڪھير
ڪهيرو|ڪھيرو
ڪهيري|ڪھيري
ڪهيلو|ڪھيلو
ڪهين|ڪھين
ڪهيڻي|ڪھيڻي
ڪهيو|ڪھيو
ڪهيون|ڪھيون
ڪواجھو|ڪواجهو
ڪوبه|ڪوبہ
ڪوتاه|ڪوتاھ
ڪوتاهه|ڪوتاھ
ڪوتاهي|ڪوتاھي
ڪوته|ڪوتہ
ڪوتهه|ڪوتہ
ڪوجھائي|ڪوجهائي
ڪوجھٽ|ڪوجهٽ
ڪوجھو|ڪوجهو
ڪوڍهه|ڪوڍه
ڪوزه|ڪوزہ
ڪوڙهه|ڪوڙه
ڪوڙھي|ڪوڙهي
ڪوڙھيو|ڪوڙهيو
ڪولاهو|ڪولاھو
ڪولھو|ڪولهو
ڪولھي|ڪولهي
ڪونجهه|ڪونجهہ
ڪونجھڙي|ڪونجهڙي
ڪونه|ڪونہ
ڪونهاٽ|ڪونھاٽ
ڪونهان|ڪونھان
ڪونهٽ|ڪونھٽ
ڪونهٽا|ڪونھٽا
ڪونهٽو|ڪونھٽو
ڪونهٽي|ڪونھٽي
ڪونهر|ڪونھر
ڪونهري|ڪونھري
ڪونهو|ڪونھو
ڪونهون|ڪونھون
ڪونهي|ڪونھي
ڪونهيارا|ڪونھيارا
ڪونھ|ڪونہ
ڪوه|ڪوھ
ڪوهاڙو|ڪوھاڙو
ڪوهٽ|ڪوھٽ
ڪوهر|ڪوھر
ڪوهري|ڪوھري
ڪوهڙ|ڪوھڙ
ڪوهستان|ڪوھستان
ڪوهستاني|ڪوھستاني
ڪوهڪ|ڪوھڪ
ڪوهلو|ڪوھلو
ڪوهڻ|ڪوھڻ
ڪوهه|ڪوھ
ڪوهو|ڪوھو
ڪوهي|ڪوھي
ڪوهيار|ڪوھيار
ڪوهيارو|ڪوھيارو
ڪوهياري|ڪوھياري
ڪوهيرو|ڪوھيرو
ڪوهيڙ|ڪوھيڙ
ڪوهيلو|ڪوھيلو
ڪوهيو|ڪوھيو
ڪويساهه|ڪويساھ
ڪيئھ|ڪيئہ
ڪياه|ڪياھ
ڪيڏانهن|ڪيڏانھن
ڪيڏانهون|ڪيڏانھون
ڪيڏانهين|ڪيڏانھين
ڪيڏنهن|ڪيڏنھن
ڪيڏنهين|ڪيڏنھين
ڪيڏھان|ڪيڏهان
ڪيڏھون|ڪيڏهون
ڪيڏھين|ڪيڏهين
ڪيڙھو|ڪيڙهو
ڪيلھڻ|ڪيلهڻ
ڪيماهه|ڪيماھ
ڪينجھر|ڪينجهر
ڪينجھرو|ڪينجهرو
ڪينهه|ڪينھہ
ڪيهت|ڪيھت
ڪيهر|ڪيھر
ڪيهڙو|ڪيھڙو
ڪيهه|ڪيھہ
ڪيهو|ڪيھو
ڪيهور|ڪيھور
ڪيهون|ڪيھون
ڪيهي|ڪيھي
گؤهر|گؤھر
گاٿنه|گاٿنہ
گاڏاهه|گاڏاھ
گاڏاهي|گاڏاھي
گاڏهون|گاڏھون
گاڏهي|گاڏھي
گاگھائڻ|گاگهائڻ
گاگھر|گاگهر
گاگھرو|گاگهرو
گانگھو|گانگهو
گانگھيٽو|گانگهيٽو
گانگھيٽي|گانگهيٽي
گانه|گانہ
گانهڻ|گانھڻ
گاه|گاھ
گاهڪ|گاھڪ
گاهڪو|گاھڪو
گاهگٽ|گاھگٽ
گاهلمائل|گاھلمائل
گاهڻ|گاھڻ
گاهه|گاھ
گاهو|گاھو
گاهي|گاھي
گاهياڻي|گاھياڻي
گاهيچارو|گاھيچارو
گاهير|گاھير
گاهيو|گاھيو
گٻهري|گٻھري
گپاگيهه|گپاگيھہ
گجگاهه|گجگاھ
گذشته|گذشتہ
گڊهڙو|گڊھڙو
گڏه|گڏھ
گڏهار|گڏھار
گڏهر|گڏھر
گڏهرو|گڏھرو
گڏهڙو|گڏھڙو
گڏهه|گڏھ
گراهڪ|گراھڪ
گراهڪي|گراھڪي
گراهه|گراھ
گربه|گربہ
گرگھلو|گرگهلو
گره|گرھ
گرهال|گرھال
گرهجڻ|گرھجڻ
گرهڙ|گرھڙ
گرهڙي|گرھڙي
گرهڻ|گرھڻ
گرهڻو|گرھڻو
گرهه|گرھ
گرهو|گرھو
گرهوڙ|گرھوڙ
گرهوڙي|گرھوڙي
گرهولي|گرھولي
گرهي|گرھي
گرهيو|گرھيو
گروهه|گروھ
گريه|گريہ
گزرگاهه|گزرگاھ
گڙهاٽ|گڙھاٽ
گڙهو|گڙھو
گگهه|گگهہ
گگھر|گگهر
گگھراٽ|گگهراٽ
گگھراٽيون|گگهراٽيون
گگھڪو|گگهڪو
گگھلڻ|گگهلڻ
گگھو|گگهو
گگھي|گگهي
گگھيرو|گگهيرو
گلبهار|گلبھار
گلچهرو|گلچھرو
گلمنهون|گلمنھون
گلهڏي|گلھڏي
گلواهه|گلواھ
گلوهه|گلوھ
گليهه|گليھہ
گمراهه|گمراھ
گمراهي|گمراھي
گمنهن|گمنھن
گناه|گناھ
گناهگاري|گناھگاري
گناهه|گناھ
گناهو|گناھو
گناهي|گناھي
گنبوجھڻ|گنبوجهڻ
گندوهڙ|گندوھڙ
گنگهه|گنگهہ
گنگھر|گنگهر
گنگھرو|گنگهرو
گنگھڻ|گنگهڻ
گنگھڻي|گنگهڻي
گنگھي|گنگهي
گنهگار|گنھگار
گنهگاري|گنھگاري
گنهن|گنھن
گنهه|گنھہ
گنهورا|گنھورا
گنهولو|گنھولو
گهاگهه|گهاگهہ
گهانگهه|گهانگهہ
گهپيهه|گهپيھہ
گهٽهڙ|گهٽھڙ
گهرام|گھرام
گهڪا|گھڪا
گهڪر|گھڪر
گهڪو|گھڪو
گهميس|گهميس
گُهميس|گُهميس
گھا|گها
گھاء|گهاء
گھائل|گهائل
گھائڻ|گهائڻ
گھائو|گهائو
گھائي|گهائي
گھاٻ|گهاٻ
گھاٻائتو|گهاٻائتو
گھاٻائي|گهاٻائي
گھاٻارو|گهاٻارو
گھاٻون|گهاٻون
گھاپ|گهاپ
گھاپاتو|گهاپاتو
گھات|گهات
گھاتڪ|گهاتڪ
گھاتو|گهاتو
گھاتي|گهاتي
گھاٽ|گهاٽ
گھاٽا|گهاٽا
گھاٽائي|گهاٽائي
گھاٽاپو|گهاٽاپو
گھاٽاڻ|گهاٽاڻ
گھاٽو|گهاٽو
گھاٽي|گهاٽي
گھاچڻ|گهاچڻ
گھاڏو|گهاڏو
گھار|گهار
گھارڻ|گهارڻ
گھارڻو|گهارڻو
گھارو|گهارو
گھاري|گهاري
گھاڙ|گهاڙ
گھاڙو|گهاڙو
گھاڙي|گهاڙي
گھاڙيٽو|گهاڙيٽو
گھاڙيٽي|گهاڙيٽي
گھاس|گهاس
گھاگھر|گهاگهر
گھاگھرو|گهاگهرو
گھامو|گهامو
گھان|گهان
گھانئر|گهانئر
گھانچ|گهانچ
گھانچڻ|گهانچڻ
گھانچو|گهانچو
گھانڊار|گهانڊار
گھانر|گهانر
گھانگھا|گهانگها
گھانگھرا|گهانگهرا
گھانگھرڪو|گهانگهرڪو
گھانگھرو|گهانگهرو
گھانگھڙو|گهانگهڙو
گھانگھو|گهانگهو
گھاڻ|گهاڻ
گھاڻا|گهاڻا
گھاڻو|گهاڻو
گھاڻي|گهاڻي
گھاوڻ|گهاوڻ
گھايا|گهايا
گھايو|گهايو
گھايون|گهايون
گھٻ|گهٻ
گھٻا|گهٻا
گھٻتي|گهٻتي
گھٻرائجڻ|گهٻرائجڻ
گھٻرائڻ|گهٻرائڻ
گھٻراٽ|گهٻراٽ
گھٻراڻ|گهٻراڻ
گھٻراھٽ|گهٻراهٽ
گھٻرو|گهٻرو
گھٻڪو|گهٻڪو
گھٻڻ|گهٻڻ
گھٻو|گهٻو
گھٻي|گهٻي
گھٻيت|گهٻيت
گھٻيڙ|گهٻيڙ
گھپ|گهپ
گھپاٽو|گهپاٽو
گھپو|گهپو
گھپي|گهپي
گھپيء|گهپيء
گھت|گهت
گھتر|گهتر
گھتڻ|گهتڻ
گھتو|گهتو
گھتوئڙو|گهتوئڙو
گھتورو|گهتورو
گھتون|گهتون
گھٽ|گهٽ
گھٽئون|گهٽئون
گھٽا|گهٽا
گھٽاء|گهٽاء
گھٽائتو|گهٽائتو
گھٽائڻ|گهٽائڻ
گھٽائيندڙ|گهٽائيندڙ
گھٽارو|گهٽارو
گھٽتا|گهٽتا
گھٽتائي|گهٽتائي
گھٽجڻ|گهٽجڻ
گھٽر|گهٽر
گھٽڙو|گهٽڙو
گھٽڪ|گهٽڪ
گھٽڪار|گهٽڪار
گھٽڪڻ|گهٽڪڻ
گھٽڪو|گهٽڪو
گھٽڻ|گهٽڻ
گھٽھڙ|گهٽھڙ
گھٽو|گهٽو
گھٽورو|گهٽورو
گھٽي|گهٽي
گھٽيء|گهٽيء
گھٽيرڙو|گهٽيرڙو
گھٽيرو|گهٽيرو
گھٽيڪا|گهٽيڪا
گھٽيون|گهٽيون
گھڃو|گهڃو
گھچ|گهچ
گھچا|گهچا
گھچپال|گهچپال
گھچپچ|گهچپچ
گھچر|گهچر
گھچڪ|گهچڪ
گھچڪو|گهچڪو
گھچڪون|گهچڪون
گھچلو|گهچلو
گھچڻ|گهچڻ
گھچو|گهچو
گھچي|گهچي
گھڊ|گهڊ
گھڏڪڻ|گهڏڪڻ
گھڏڻ|گهڏڻ
گھر|گهر
گھرء|گهرء
گھرا|گهرا
گھرائتو|گهرائتو
گھرائڻ|گهرائڻ
گھرائي|گهرائي
گھراماڻي|گهراماڻي
گھراڻ|گهراڻ
گھراڻو|گهراڻو
گھرت|گهرت
گھرتيون|گهرتيون
گھرٽ|گهرٽ
گھرٽڻ|گهرٽڻ
گھرٽو|گهرٽو
گھرٽي|گهرٽي
گھرج|گهرج
گھرجائو|گهرجائو
گھرجڻ|گهرجڻ
گھرجي|گهرجي
گھررڻ|گهررڻ
گھرڙ|گهرڙ
گھرڙائڻ|گهرڙائڻ
گھرڙاٽ|گهرڙاٽ
گھرڙاٽو|گهرڙاٽو
گھرڙڪو|گهرڙڪو
گھرڙڻ|گهرڙڻ
گھرڙو|گهرڙو
گھرڙي|گهرڙي
گھرس|گهرس
گھرکي|گهرکي
گھرڪائڻ|گهرڪائڻ
گھرڪجڻ|گهرڪجڻ
گھرڪڻ|گهرڪڻ
گھرڪو|گهرڪو
گھرڪي|گهرڪي
گھرگو|گهرگو
گھرلو|گهرلو
گھرن|گهرن
گھرڻ|گهرڻ
گھرڻا|گهرڻا
گھرڻي|گهرڻي
گھرو|گهرو
گھروڙڻ|گهروڙڻ
گھروڙي|گهروڙي
گھري|گهري
گھريا|گهريا
گھريتڙو|گهريتڙو
گھريتڙي|گهريتڙي
گھريتو|گهريتو
گھريتي|گهريتي
گھريچو|گهريچو
گھريلو|گهريلو
گھريو|گهريو
گھريون|گهريون
گھڙ|گهڙ
گھڙا|گهڙا
گھڙائڻ|گهڙائڻ
گھڙائي|گهڙائي
گھڙامنجي|گهڙامنجي
گھڙانجي|گهڙانجي
گھڙاڻي|گهڙاڻي
گھڙٻ|گهڙٻ
گھڙٻو|گهڙٻو
گھڙٻون|گهڙٻون
گھڙٻي|گهڙٻي
گھڙٻيلڻ|گهڙٻيلڻ
گھڙپ|گهڙپ
گھڙپو|گهڙپو
گھڙڀچ|گهڙڀچ
گھڙت|گهڙت
گھڙجڻ|گهڙجڻ
گھڙچڪ|گهڙچڪ
گھڙڪڻ|گهڙڪڻ
گھڙڪو|گهڙڪو
گھڙگھاٽ|گهڙگهاٽ
گھڙنئاڌار|گهڙنئاڌار
گھڙڻ|گهڙڻ
گھڙڻي|گهڙڻي
گھڙو|گهڙو
گھڙولو|گهڙولو
گھڙي|گهڙي
گھڙيء|گهڙيء
گھڙيال|گهڙيال
گھڙيالچو|گهڙيالچو
گھڙيالچي|گهڙيالچي
گھڙيالو|گهڙيالو
گھڙيل|گهڙيل
گھڙيو|گهڙيو
گھس|گهس
گھسڻ|گهسڻ
گھش|گهش
گھشو|گهشو
گھگھائڻ|گهگهائڻ
گھگھتي|گهگهتي
گھگھٽي|گهگهٽي
گھگھر|گهگهر
گھگھراٽي|گهگهراٽي
گھگھراٽيون|گهگهراٽيون
گھگھرو|گهگهرو
گھگھري|گهگهري
گھگھڙو|گهگهڙو
گھگھلڻ|گهگهلڻ
گھگھليو|گهگهليو
گھگھه|گهگهہ
گھگھو|گهگهو
گھگھي|گهگهي
گھگھيتڙو|گهگهيتڙو
گھگھيرڻ|گهگهيرڻ
گھگھيري|گهگهيري
گھگھيلي|گهگهيلي
گھگھيون|گهگهيون
گھگير|گهگير
گھل|گهل
گھلا|گهلا
گھلپور|گهلپور
گھلر|گهلر
گھلريو|گهلريو
گھلڙا|گهلڙا
گھلڪرڻ|گهلڪرڻ
گھلڪي|گهلڪي
گھلڻ|گهلڻ
گھلو|گهلو
گھلوڙو|گهلوڙو
گھلوڙي|گهلوڙي
گھلي|گهلي
گھليجا|گهليجا
گھليون|گهليون
گھم|گهم
گھمائن|گهمائن
گھمائڻ|گهمائڻ
گھمائي|گهمائي
گھماٽجن|گهماٽجن
گھماٽي|گهماٽي
گھماگھم|گهماگهم
گھمتاري|گهمتاري
گھمٽ|گهمٽ
گھمجڻ|گهمجڻ
گھمچر|گهمچر
گھمر|گهمر
گھمرا|گهمرا
گھمرڻ|گهمرڻ
گھمرو|گهمرو
گھمري|گهمري
گھمسان|گهمسان
گھمساڻ|گهمساڻ
گھمگھمو|گهمگهمو
گھمگوڙ|گهمگوڙ
گھمن|گهمن
گھمندڙ|گهمندڙ
گھمندو|گهمندو
گھمنڊ|گهمنڊ
گھمنڊي|گهمنڊي
گھمڻ|گهمڻ
گھمڻگھوٽو|گهمڻگهوٽو
گھمـي|گهمـي
گھن|گهن
گھنپتريون|گهنپتريون
گھنڀر|گهنڀر
گھنتري|گهنتري
گھنٽو|گهنٽو
گھنٽي|گهنٽي
گھنج|گهنج
گھنجائڻ|گهنجائڻ
گھنججڻ|گهنججڻ
گھنجر|گهنجر
گھنجڻ|گهنجڻ
گھنجڻا|گهنجڻا
گھنڃ|گهنڃ
گھنچي|گهنچي
گھنڊ|گهنڊ
گھنڊارو|گهنڊارو
گھنڊاڻو|گهنڊاڻو
گھنڊرڪ|گهنڊرڪ
گھنڊڙي|گهنڊڙي
گھنڊڪي|گهنڊڪي
گھنڊلاڙ|گهنڊلاڙ
گھنڊلي|گهنڊلي
گھنڊڻي|گهنڊڻي
گھنڊو|گهنڊو
گھنڊي|گهنڊي
گھنڊيء|گهنڊيء
گھنڊيارو|گهنڊيارو
گھنڊيدار|گهنڊيدار
گھنڊيلڻ|گهنڊيلڻ
گھنڪائڻ|گهنڪائڻ
گھنگھٽ|گهنگهٽ
گھنگھر|گهنگهر
گھنگھرجڻ|گهنگهرجڻ
گھنگھرو|گهنگهرو
گھنگھريو|گهنگهريو
گھنگھڻ|گهنگهڻ
گھنگھڻو|گهنگهڻو
گھنگھڻي|گهنگهڻي
گھنگھور|گهنگهور
گھنڻ|گهنڻ
گھنوارا|گهنوارا
گھني|گهني
گھنيا|گهنيا
گھنيون|گهنيون
گھڻ|گهڻ
گھڻا|گهڻا
گھڻائڻ|گهڻائڻ
گھڻائي|گهڻائي
گھڻڪار|گهڻڪار
گھڻڪڻ|گهڻڪڻ
گھڻگھرائي|گهڻگهرائي
گھڻگھرو|گهڻگهرو
گھڻگور|گهڻگور
گھڻو|گهڻو
گھڻي|گهڻي
گھڻيرڙو|گهڻيرڙو
گھڻيرو|گهڻيرو
گھڻيون|گهڻيون
گھھ|گهہ
گھو|گهو
گھوئڻ|گهوئڻ
گھوئي|گهوئي
گھوارو|گهوارو
گھوٻاٽو|گهوٻاٽو
گھوٻاري|گهوٻاري
گھوٻو|گهوٻو
گھوٻي|گهوٻي
گھوتاکائڻ|گهوتاکائڻ
گھوتو|گهوتو
گھوتي|گهوتي
گھوٽا|گهوٽا
گھوٽارو|گهوٽارو
گھوٽالائڻ|گهوٽالائڻ
گھوٽالو|گهوٽالو
گھوٽاڻا|گهوٽاڻا
گھوٽڪو|گهوٽڪو
گھوٽڪي|گهوٽڪي
گھوٽڻ|گهوٽڻ
گھوٽو|گهوٽو
گھوٽي|گهوٽي
گھوٽيتو|گهوٽيتو
گھوجار|گهوجار
گھوچ|گهوچ
گھوچائي|گهوچائي
گھوچان|گهوچان
گھوچڻ|گهوچڻ
گھوچو|گهوچو
گھور|گهور
گھورا|گهورا
گھورائو|گهورائو
گھورارو|گهورارو
گھوراڙ|گهوراڙ
گھوراڙا|گهوراڙا
گھوراڙو|گهوراڙو
گھوران|گهوران
گھوربتو|گهوربتو
گھورپ|گهورپ
گھورڙيو|گهورڙيو
گھورن|گهورن
گھورڻ|گهورڻ
گھورڻو|گهورڻو
گھورو|گهورو
گھورون|گهورون
گھوري|گهوري
گھوريندڙ|گهوريندڙ
گھوريو|گهوريو
گھوريون|گهوريون
گھوڙا|گهوڙا
گھوڙاٻاڙي|گهوڙاٻاڙي
گھوڙال|گهوڙال
گھوڙاول|گهوڙاول
گھوڙن|گهوڙن
گھوڙو|گهوڙو
گھوڙي|گهوڙي
گھوڙيال|گهوڙيال
گھوڙيچو|گهوڙيچو
گھوڙيل|گهوڙيل
گھوڙيو|گهوڙيو
گھوسو|گهوسو
گھوڪ|گهوڪ
گھوڪا|گهوڪا
گھوڪر|گهوڪر
گھوڪرون|گهوڪرون
گھوڪڻ|گهوڪڻ
گھوڪڻو|گهوڪڻو
گھوڪو|گهوڪو
گھوگھاء|گهوگهاء
گھوگھاٽ|گهوگهاٽ
گھوگھارو|گهوگهارو
گھوگھاري|گهوگهاري
گھوگھاڙو|گهوگهاڙو
گھوگھٽ|گهوگهٽ
گھوگھر|گهوگهر
گھوگھرو|گهوگهرو
گھوگھري|گهوگهري
گھوگھڙ|گهوگهڙ
گھوگھڻ|گهوگهڻ
گھوگھھ|گهوگهہ
گھوگھو|گهوگهو
گھوگھي|گهوگهي
گھوگھيتو|گهوگهيتو
گھول|گهول
گھولر|گهولر
گھولرو|گهولرو
گھولڻ|گهولڻ
گھوليو|گهوليو
گھوماٽ|گهوماٽ
گھوماٽجڻ|گهوماٽجڻ
گھوماٽڻ|گهوماٽڻ
گھوماٽي|گهوماٽي
گھومر|گهومر
گھومو|گهومو
گھون|گهون
گھونسڻ|گهونسڻ
گھونگھاٽ|گهونگهاٽ
گھونگھٽ|گهونگهٽ
گھونگھچي|گهونگهچي
گھونگھڻ|گهونگهڻ
گھونگھڻو|گهونگهڻو
گھونگھو|گهونگهو
گھي|گهي
گھيٻٽ|گهيٻٽ
گھيپ|گهيپ
گھيتارڻ|گهيتارڻ
گھيتلو|گهيتلو
گھيٽڙو|گهيٽڙو
گھيٽڪ|گهيٽڪ
گھيٽڪي|گهيٽڪي
گھيٽو|گهيٽو
گھيٽي|گهيٽي
گھيجا|گهيجا
گھيچ|گهيچ
گھيچا|گهيچا
گھيچائڻ|گهيچائڻ
گھيچڻ|گهيچڻ
گھيچو|گهيچو
گھير|گهير
گھيرا|گهيرا
گھيرٽ|گهيرٽ
گھيردار|گهيردار
گھيرڻ|گهيرڻ
گھيرو|گهيرو
گھيري|گهيري
گھيريون|گهيريون
گھيڙ|گهيڙ
گھيڙان|گهيڙان
گھيڙجھلڻ|گهيڙجهلڻ
گھيڙن|گهيڙن
گھيڙڻ|گهيڙڻ
گھيڙو|گهيڙو
گھيسو|گهيسو
گھيڪ|گهيڪ
گھيل|گهيل
گھيلڙا|گهيلڙا
گھيم|گهيم
گھينٽيا|گهينٽيا
گھينگھر|گهينگهر
گھينگھھ|گهينگهہ
گھينگھو|گهينگهو
گھيڻ|گهيڻ
گواهي|گواھي
گواھھ|گواھ
گورانهي|گورانھي
گوراهه|گوراھ
گورهاڙي|گورھاڙي
گورھو|گورهو
گورھيڙو|گورهيڙو
گوڙھواڙ|گوڙهواڙ
گوشه|گوشہ
گوگھاٽ|گوگهاٽ
گوگھٽ|گوگهٽ
گوگھرو|گوگهرو
گوگھري|گوگهري
گوگھڻ|گوگهڻ
گوگھھ|گوگهہ
گوگھو|گوگهو
گوگھيتو|گوگهيتو
گوگھيٽا|گوگهيٽا
گوگھيڙو|گوگهيڙو
گونگھٽ|گونگهٽ
گونگھڻ|گونگهڻ
گونگھو|گونگهو
گونگھي|گونگهي
گونهاندي|گونھاندي
گونهٽ|گونھٽ
گونهر|گونھر
گونهن|گونھن
گونهه|گونھہ
گوها|گوھا
گوهٽ|گوھٽ
گوهر|گوھر
گوهري|گوھري
گوهڙ|گوھڙ
گوهڙجي|گوھڙجي
گوهڻ|گوھڻ
گوهو|گوھو
گوهي|گوھي
گوهير|گوھير
گوهيڙ|گوھيڙ
گوهيون|گوھيون
گيڙھي|گيڙهي
گيگھر|گيگهر
گيگھھ|گيگهہ
گيلھڙ|گيلهڙ
گينڊاهو|گينڊاھو
گينگھڙا|گينگهڙا
گينگھو|گينگهو
گينگھي|گينگهي
گينواهه|گينواھ
گيها|گيھا
گيهر|گيھر
گيهرڻ|گيھرڻ
گيهڙ|گيھڙ
گيهلپور|گيھلپور
گيهه|گيھہ
گيهو|گيھو
گيهول|گيھول
گيهون|گيھون
گيهي|گيھي
گيهيلڙا|گيھيلڙا
ڳئه|ڳئہ
ڳاجھھ|ڳاجهہ
ڳارانجھو|ڳارانجهو
ڳارڙھي|ڳارڙهي
ڳاڙھا|ڳاڙها
ڳاڙھائڻ|ڳاڙهائڻ
ڳاڙھائي|ڳاڙهائي
ڳاڙھانجھو|ڳاڙهانجهو
ڳاڙھاڻ|ڳاڙهاڻ
ڳاڙھڪو|ڳاڙهڪو
ڳاڙھھ|ڳاڙه
ڳاڙھو|ڳاڙهو
ڳاڙھي|ڳاڙهي
ڳاڙھيرو|ڳاڙهيرو
ڳاڙھيون|ڳاڙهيون
ڳالهه|ڳالهہ
ڳالهہ|ڳالھ
ڳالھاء|ڳالهاء
ڳالھائڻ|ڳالهائڻ
ڳالھائڻو|ڳالهائڻو
ڳالھائو|ڳالهائو
ڳالھايو|ڳالهايو
ڳالھر|ڳالهر
ڳالھڙ|ڳالهڙ
ڳالھڙي|ڳالهڙي
ڳالھه|ڳالھہ
ڳالھھ|ڳالهہ
ڳالھو|ڳالهو
ڳالھوڙ|ڳالهوڙ
ڳالھوڙو|ڳالهوڙو
ڳالھيار|ڳالهيار
ڳالھير|ڳالهير
ڳالھين|ڳالهين
ڳالھيو|ڳالهيو
ڳالھيون|ڳالهيون
ڳاها|ڳاھا
ڳاهٽ|ڳاھٽ
ڳاهڪي|ڳاھڪي
ڳاهنيار|ڳاھنيار
ڳاهڻ|ڳاھڻ
ڳاهه|ڳاھ
ڳاهو|ڳاھو
ڳاهوٽ|ڳاھوٽ
ڳاهوٽي|ڳاھوٽي
ڳاهون|ڳاھون
ڳاهويا|ڳاھويا
ڳاهي|ڳاھي
ڳاهيجا|ڳاھيجا
ڳاهيجي|ڳاھيجي
ڳجهه|ڳجهہ
ڳجھائتو|ڳجهائتو
ڳجھائي|ڳجهائي
ڳجھارت|ڳجهارت
ڳجھاندر|ڳجهاندر
ڳجھاندرو|ڳجهاندرو
ڳجھٽ|ڳجهٽ
ڳجھڙ|ڳجهڙ
ڳجھڙو|ڳجهڙو
ڳجھڙي|ڳجهڙي
ڳجھھ|ڳجهہ
ڳجھو|ڳجهو
ڳچهڻڻ|ڳچھڻڻ
ڳرانجھڙو|ڳرانجهڙو
ڳراهٽي|ڳراھٽي
ڳراهڙو|ڳراھڙو
ڳراهڙي|ڳراھڙي
ڳراهو|ڳراھو
ڳرهائو|ڳرھائو
ڳرهاٽڙي|ڳرھاٽڙي
ڳرهاڙي|ڳرھاڙي
ڳرهاڻي|ڳرھاڻي
ڳرهجڻ|ڳرھجڻ
ڳرهچا|ڳرھچا
ڳرهڙي|ڳرھڙي
ڳرهڻ|ڳرھڻ
ڳرهه|ڳره
ڳرهو|ڳرھو
ڳڙه|ڳڙه
ڳڙهاري|ڳڙھاري
ڳڙهڻ|ڳڙهڻ
ڳڙهه|ڳڙهہ
ڳڙھھ|ڳڙه
ڳڙھي|ڳڙهي
ڳڙھيل|ڳڙهيل
ڳڙھيون|ڳڙهيون
ڳلهه|ڳلهہ
ڳلھر|ڳلهر
ڳلھڻ|ڳلهڻ
ڳلھو|ڳلهو
ڳلھي|ڳلهي
ڳمهه|ڳمهہ
ڳنھڙي|ڳنهڙي
ڳنھڻ|ڳنهڻ
ڳنھي|ڳنهي
ڳڻپهه|ڳڻپھہ
ڳهائڻ|ڳھائڻ
ڳهت|ڳھت
ڳهٽ|ڳھٽ
ڳهڃ|ڳھڃ
ڳهر|ڳھر
ڳهرجڻ|ڳھرجڻ
ڳهريو|ڳھريو
ڳهڙ|ڳھڙ
ڳهڙٻي|ڳھڙٻي
ڳهڳڻ|ڳھڳڻ
ڳهلائپ|ڳھلائپ
ڳهلائڻ|ڳھلائڻ
ڳهلائي|ڳھلائي
ڳهلائيون|ڳھلائيون
ڳهلاڻو|ڳھلاڻو
ڳهلو|ڳھلو
ڳهموڙ|ڳھموڙ
ڳهن|ڳھن
ڳهڻ|ڳھڻ
ڳهڻو|ڳھڻو
ڳهڻي|ڳھڻي
ڳهه|ڳھہ
ڳهو|ڳھو
ڳهي|ڳھي
ڳهير|ڳھير
ڳهيل|ڳھيل
ڳهيلا|ڳھيلا
ڳهيلائڻ|ڳھيلائڻ
ڳهيلائي|ڳھيلائي
ڳهيلاڻو|ڳھيلاڻو
ڳهيلڙا|ڳھيلڙا
ڳهيلو|ڳھيلو
ڳوراها|ڳوراھا
ڳوراهو|ڳوراھو
ڳوراهون|ڳوراھون
ڳورهاري|ڳورھاري
ڳورهيلو|ڳورھيلو
ڳوڙھ|ڳوڙه
ڳوڙھا|ڳوڙها
ڳوڙھائي|ڳوڙهائي
ڳوڙھاپڻ|ڳوڙهاپڻ
ڳوڙھاڻ|ڳوڙهاڻ
ڳوڙھن|ڳوڙهن
ڳوڙھھ|ڳوڙه
ڳوڙھو|ڳوڙهو
ڳوڙھي|ڳوڙهي
ڳوڙھيرو|ڳوڙهيرو
ڳوڙھيون|ڳوڙهيون
ڳولھا|ڳولها
ڳولھھ|ڳولهہ
ڳونهي|ڳونھي
ڳوهاٽي|ڳوھاٽي
ڳوهت|ڳوھت
ڳوهڻ|ڳوھڻ
ڳوهه|ڳوھ
ڳوهو|ڳوھو
ڳوهيرو|ڳوھيرو
ڳوهينڊو|ڳوھينڊو
ڳيجھڙو|ڳيجهڙو
ڳيجھھ|ڳيجهہ
ڳيجھو|ڳيجهو
ڳيرانجھڙو|ڳيرانجهڙو
ڳيڙھڻ|ڳيڙهڻ
ڳيڙھو|ڳيڙهو
ڳيلھڙ|ڳيلهڙ
ڳينجھڙي|ڳينجهڙي
ڳينھو|ڳينهو
ڳيهڙو|ڳيھڙو
ڳيهن|ڳيھن
ڳيهڻ|ڳيھڻ
ڳيهڻو|ڳيھڻو
ڳيهون|ڳيھون
ڳيهي|ڳيھي
لئه|لئہ
لئهِ|لئہِ
لاڙهه|لاڙه
لاڙھو|لاڙهو
لاڙھي|لاڙهي
لاکهڻ|لاکھڻ
لاگهه|لاگهہ
لالانگھر|لالانگهر
لالانگھرو|لالانگهرو
لالانگھري|لالانگهري
لالانگھو|لالانگهو
لالجھڻ|لالجهڻ
لالرھجڻ|لالرهجڻ
لالنگھھ|لالنگهہ
لالواهه|لالواھ
لامذهب|لامذھب
لامهير|لامھير
لانجھائي|لانجهائي
لانجھارو|لانجهارو
لانجھھ|لانجهہ
لانجھو|لانجهو
لانگاهه|لانگاھ
لانگھا|لانگها
لانگھائو|لانگهائو
لانگھائي|لانگهائي
لانگھاڻو|لانگهاڻو
لانگھاڻي|لانگهاڻي
لانگھڙجي|لانگهڙجي
لانگھو|لانگهو
لانگوهه|لانگوھ
لانهن|لانھن
لاهائتو|لاھائتو
لاهاتو|لاھاتو
لاهارو|لاھارو
لاهاريو|لاھاريو
لاهٽڻ|لاھٽڻ
لاهرو|لاھرو
لاهڻ|لاھڻ
لاَهِڻُ|لاَھِڻُ
لاهڻي|لاھڻي
لاهه|لاھ
لاهو|لاھو
لاهوارو|لاھوارو
لاهوت|لاھوت
لاهوتي|لاھوتي
لاهوتيڪو|لاھوتيڪو
لاهور|لاھور
لاهوري|لاھوري
لاهوڙيو|لاھوڙيو
لاهوڪڙ|لاھوڪڙ
لاهي|لاھي
لاهيارو|لاھيارو
لاهيوار|لاھيوار
لاهيون|لاھيون
لجھڻ|لجهڻ
لجھھ|لجهہ
لڄهڙو|لڄھڙو
لچڪه|لچڪہ
لڌاهو|لڌاھو
لرهو|لرھو
لڙھائڻ|لڙهائڻ
لڙھاڪو|لڙهاڪو
لڙھندي|لڙهندي
لڙھڻ|لڙهڻ
لڙھھ|لڙه
لڙھو|لڙهو
لڙھي|لڙهي
لکاپڙھي|لکاپڙهي
لکپڙھھ|لکپڙه
لگھات|لگهات
لگھاتون|لگهاتون
لگھتي|لگهتي
لگھھ|لگهه
لڳهه|لڳھہ
للاهون|للاھون
للنگھھ|للنگهہ
للھا|للها
للھڪار|للهڪار
للھنگ|للهنگ
للھو|للهو
للھور|للهور
للھوڙي|للهوڙي
للھيو|للهيو
لنجھڻ|لنجهڻ
لنجھھ|لنجهہ
لنگھا|لنگها
لنگھائڻ|لنگهائڻ
لنگھائي|لنگهائي
لنگھڻ|لنگهڻ
لنگھڻي|لنگهڻي
لنگھھ|لنگهہ
لنگھو|لنگهو
لنگھي|لنگهي
لنگھيجي|لنگهيجي
لنگھيل|لنگهيل
لنوھار|لنوهار
لڻجھھ|لڻجهہ
لهاچ|لھاچ
لهار|لھار
لهاراڻي|لھاراڻي
لهارڪو|لھارڪو
لهانجو|لھانجو
لهانڊڙو|لھانڊڙو
لهانڊو|لھانڊو
لهاڻا|لھاڻا
لهاڻو|لھاڻو
لهٻر|لھٻر
لهپ|لھپ
لهٽڻ|لھٽڻ
لهجڻ|لھجڻ
لهجو|لھجو
لهچهه|لھچھہ
لهٰذا|لھٰذا
لهر|لھر
لهرائتو|لھرائتو
لهرائڻ|لھرائڻ
لهرائڻي|لھرائڻي
لهراڻي|لھراڻي
لهردار|لھردار
لهرروڪ|لھرروڪ
لهرڪ|لھرڪ
لهرو|لھرو
لهري|لھري
لهريائون|لھريائون
لهريجا|لھريجا
لهريون|لھريون
لهڙ|لھڙ
لهڙو|لھڙو
لهڙي|لھڙي
لهس|لھس
لهسائڻ|لھسائڻ
لهسڄڻ|لھسڄڻ
لهسلنگ|لھسلنگ
لهسڻ|لھسڻ
لهسيا|لھسيا
لهڪ|لھڪ
لهڪارجڻ|لھڪارجڻ
لهڪاڻجڻ|لھڪاڻجڻ
لهڪاڻيل|لھڪاڻيل
لهڪڻ|لھڪڻ
لهلهائڻ|لھلھائڻ
لهلهه|لھلھہ
لهلور|لھلور
لهم|لھم
لهندو|لھندو
لهندي|لھندي
لهنڊ|لھنڊ
لهنڊا|لھنڊا
لهنوار|لھنوار
لهڻ|لھڻ
لهڻا|لھڻا
لهڻڻ|لھڻڻ
لهڻو|لھڻو
لهڻون|لھڻون
لهڻي|لھڻي
لهڻيات|لھڻيات
لهڻيدار|لھڻيدار
لهه|لھہ
لهو|لھو
لهوار|لھوار
لهوارو|لھوارو
لهواريون|لھواريون
لهويه|لھويہ
لهي|لھي
لهيرو|لھيرو
لهيو|لھيو
لھھ|لھہ
لوامه|لوامہ
لوجھھ|لوجهہ
لوڙھائو|لوڙهائو
لوڙھاڏ|لوڙهاڏ
لوڙھڻ|لوڙهڻ
لوڙھھ|لوڙهه
لوڙھو|لوڙهو
لوڙھي|لوڙهي
لوڙھيو|لوڙهيو
لوڙھيون|لوڙهيون
لوگھو|لوگهو
لولھاٽ|لولهاٽ
لولھٽ|لولهٽ
لولھر|لولهر
لولھرو|لولهرو
لولھڙاٽ|لولهڙاٽ
لونجھان|لونجهان
لونجھھ|لونجهہ
لونگھٽ|لونگهٽ
لونهون|لونھون
لوڻيهار|لوڻيھار
لوهئون|لوھئون
لوها|لوھا
لوهاٽ|لوھاٽ
لوهاٽجي|لوھاٽجي
لوهاٽيل|لوھاٽيل
لوهار|لوھار
لوهاراڻي|لوھاراڻي
لوهارڪو|لوھارڪو
لوهاڪوٽ|لوھاڪوٽ
لوهانئان|لوھانئان
لوهانئون|لوھانئون
لوهانڊو|لوھانڊو
لوهاني|لوھاني
لوهاڻا|لوھاڻا
لوهاڻڪو|لوھاڻڪو
لوهاڻڻ|لوھاڻڻ
لوهاڻون|لوھاڻون
لوهجڻ|لوھجڻ
لوهجي|لوھجي
لوهر|لوھر
لوهرٽي|لوھرٽي
لوهرڪو|لوھرڪو
لوهريو|لوھريو
لوهڙ|لوھڙ
لوهڙي|لوھڙي
لوهن|لوھن
لوهڻ|لوھڻ
لوهڻي|لوھڻي
لوهڻيون|لوھڻيون
لوهه|لوھ
لوهو|لوھو
لوهوڪو|لوھوڪو
لوهي|لوھي
لوهيڙو|لوھيڙو
لوهيون|لوھيون
ليٽهڙو|ليٽھڙو
ليجھھ|ليجهہ
ليڳھھ|ليڳهه
ليلنگھھ|ليلنگهہ
ليلھائڻ|ليلهائڻ
ليلھار|ليلهار
ليلھاري|ليلهاري
ليلھاريو|ليلهاريو
ليلھر|ليلهر
ليلھڙ|ليلهڙ
ليلھھ|ليلهہ
ليلھو|ليلهو
ليلھوڙو|ليلهوڙو
لينجھھ|لينجهہ
لينڊاهو|لينڊاھو
لينگھا|لينگها
لينگھائتو|لينگهائتو
لينگھھ|لينگهه
لينگھو|لينگهو
لينگھون|لينگهون
ليهائتو|ليھائتو
ليهاري|ليھاري
ليهان|ليھان
ليهڙي|ليھڙي
ليهڻ|ليھڻ
ليهه|ليھہ
ليهو|ليھو
ماجھي|ماجهي
مادئيمهرو|مادئيمھرو
ماده|مادہ
ماديمهون|ماديمھون
ماڏھوڙ|ماڏهوڙ
ماڏھين|ماڏهين
ماڙھا|ماڙها
ماڙھپائي|ماڙهپائي
ماڙھپو|ماڙهپو
ماڙھو|ماڙهو
ماسياه|ماسياھ
مافيها|مافيھا
ماڪاهي|ماڪاھي
ماڳڊهڻ|ماڳڊھڻ
ماڳهين|ماڳھين
مالاهو|مالاھو
مالھا|مالها
مالھارو|مالهارو
مالھاري|مالهاري
مالھبيئا|مالهبيئا
مالھڻ|مالهڻ
مالھڻو|مالهڻو
مالھھ|مالهہ
مالھو|مالهو
مالھي|مالهي
ماموه|ماموھ
مانجھاڪو|مانجهاڪو
مانجھان|مانجهان
مانجھاندا|مانجهاندا
مانجھاندڙي|مانجهاندڙي
مانجھاندڻي|مانجهاندڻي
مانجھاندو|مانجهاندو
مانجھاندي|مانجهاندي
مانجھاڻو|مانجهاڻو
مانجھاڻي|مانجهاڻي
مانجھلي|مانجهلي
مانجھند|مانجهند
مانجھڻ|مانجهڻ
مانجھھ|مانجهہ
مانجھو|مانجهو
مانجھولو|مانجهولو
مانجھي|مانجهي
مانجھياڻي|مانجهياڻي
مانجھيرو|مانجهيرو
مانجھيلو|مانجهيلو
مانگھھ|مانگهہ
مانگھي|مانگهي
مانهند|مانھند
مانهه|مانھہ
مانهيان|مانھيان
مانهين|مانھين
مانھ|مانہ
ماڻھئائي|ماڻهئائي
ماڻھان|ماڻهان
ماڻھپائي|ماڻهپائي
ماڻھپو|ماڻهپو
ماڻھپي|ماڻهپي
ماڻھن|ماڻهن
ماڻھو|ماڻهو
ماڻھوئڙو|ماڻهوئڙو
ماه|ماھ
ماهان|ماھان
ماهتاب|ماھتاب
ماهتابي|ماھتابي
ماهر|ماھر
ماهرو|ماھرو
ماهڙ|ماھڙ
ماهل|ماھل
ماهنڊ|ماھنڊ
ماهه|ماھ
ماهو|ماھو
ماهوئي|ماھوئي
ماهوار|ماھوار
ماهواري|ماھواري
ماهوت|ماھوت
ماهوٽا|ماھوٽا
ماهوٽو|ماھوٽو
ماهوجا|ماھوجا
ماهون|ماھون
ماهي|ماھي
ماهيانو|ماھيانو
ماهيت|ماھيت
ماهيچو|ماھيچو
ماهيڙ|ماھيڙ
ماهيڙو|ماھيڙو
ماهيڙياڻي|ماھيڙياڻي
ماهيلو|ماھيلو
ماهين|ماھين
ماهينڊ|ماھينڊ
ماهيو|ماھيو
ماھھ|ماھہ
مايه|مايہ
مباهي|مباھي
مبهم|مبھم
مبهوت|مبھوت
متاهه|متاھ
متشابهه|متشابھہ
متعارفه|متعارفہ
متعهد|متعھد
متناهي|متناھي
متنبهه|متنبھہ
متهبو|متھبو
متهر|متھر
متهلو|متھلو
متوارثه|متوارثہ
متوجهه|متوجھہ
مثانه|مثانہ
مٿانهون|مٿانھون
مٿانهين|مٿانھين
مٿاهر|مٿاھر
مٿاهون|مٿاھون
مٿاهين|مٿاھين
مٿمنهون|مٿمنھون
مجاهد|مجاھد
مجتهد|مجتھد
مجهد|مجھد
مجهول|مجھول
مجھاندڙو|مجهاندڙو
مجھوڙو|مجهوڙو
مڇيهه|مڇيھہ
محاصره|محاصرہ
محاوره|محاورہ
مختلفه|مختلفہ
مخواه|مخواھ
مدارالنهار|مدارالنھار
مدحيه|مدحيہ
مدنگاهه|مدنگاھ
مذاقيه|مذاقيہ
مذهب|مذھب
مذهبي|مذھبي
مڏباهو|مڏباھو
مڏهاڙ|مڏھاڙ
مڏهين|مڏھين
مراهيون|مراھيون
مرتبه|مرتبہ
مرثيه|مرثيہ
مرچوهه|مرچوھ
مرداسنگھھ|مرداسنگهہ
مرده|مردہ
مرزهه|مرزہ
مرگهه|مرگهه
مرگھٽ|مرگهٽ
مرگھه|مرگھہ
مرگھي|مرگهي
مرگھيل|مرگهيل
مره|مرہ
مرهٽو|مرھٽو
مرهٽي|مرھٽي
مرهڏي|مرھڏي
مرهم|مرھم
مرهڻ|مرھڻ
مرهه|مرہ
مرهو|مرھو
مرهون|مرھون
مرهونمنت|مرھونمنت
مرهي|مرھي
مرهيات|مرھيات
مرهياتو|مرھياتو
مرهياڙي|مرھياڙي
مروه|مروھ
مڙھائڻ|مڙهائڻ
مڙھت|مڙهت
مڙھڻ|مڙهڻ
مڙھڻي|مڙهڻي
مڙھھ|مڙه
مڙھو|مڙهو
مڙھوصو|مڙهوصو
مڙھي|مڙهي
مڙھيار|مڙهيار
مسهل|مسھل
مسهو|مسھو
مشابهت|مشابھت
مشابهه|مشابهہ
مشاهدو|مشاھدو
مشاهره|مشاھرہ
مشتبهه|مشتبھہ
مشتهر|مشتھر
مشهدو|مشھدو
مشهدي|مشھدي
مشهور|مشھور
مشهورائي|مشھورائي
مشهوري|مشھوري
مصافحه|مصافحہ
مطمئنه|مطمئنہ
مُطَهَرُ|مُطَھَرُ
مطهرات|مطھرات
مظهر|مظھر
معامله|معاملہ
معاهدو|معاھدو
معرڪه|معرڪہ
مفهوم|مفھوم
مقابله|مقابلہ
مقصوره|مقصورہ
مکڻهارو|مکڻھارو
مکه|مکہ
مڪراهه|مڪراھ
مڪروه|مڪروھ
مڪروهه|مڪروھ
مگھا|مگها
مگھٽ|مگهٽ
مگھن|مگهن
مگھو|مگهو
مگيه|مگيہ
مڱڻهار|مڱڻھار
ملفوظه|ملفوظہ
ملڪه|ملڪہ
ملنگھھ|ملنگهہ
ملھائتو|ملهائتو
ملھائڻ|ملهائڻ
ملھار|ملهار
ملھارو|ملهارو
ملھالو|ملهالو
ملھٽڻ|ملهٽڻ
ملھڙو|ملهڙو
ملھڻ|ملهڻ
ملھڻو|ملهڻو
ملھھ|ملهہ
ملھو|ملهو
ملھي|ملهي
ملھيار|ملهيار
ملھير|ملهير
ملھيو|ملهيو
ملواهه|ملواھ
مليراهه|مليراھ
مناهڪي|مناھڪي
مناهي|مناھي
مناهيجا|مناھيجا
منتهيٰ|منتھيٰ
منجهه|منجهہ
منجھئن|منجهئن
منجھائتو|منجهائتو
منجھائڻ|منجهائڻ
منجھار|منجهار
منجھارا|منجهارا
منجھارو|منجهارو
منجھارون|منجهارون
منجھان|منجهان
منجھاندڙو|منجهاندڙو
منجھاندڻو|منجهاندڻو
منجھانھون|منجهانهون
منجھلو|منجهلو
منجھند|منجهند
منجھڻ|منجهڻ
منجھڻي|منجهڻي
منجھه|منجھہ
منجھھ|منجهہ
منجھو|منجهو
منجھولو|منجهولو
منجھون|منجهون
منجھي|منجهي
منجھيان|منجهيان
مندخواهه|مندخواھ
مندخواهي|مندخواھي
منڏهو|منڏھو
منصفانهه|منصفانھہ
منقوله|منقولہ
منڪوحه|منڪوحہ
منگھائي|منگهائي
منگھٽ|منگهٽ
منگھچ|منگهچ
منگھر|منگهر
منگھن|منگهن
منگھڻ|منگهڻ
منگھھ|منگهہ
منگھو|منگهو
منگھي|منگهي
منگھير|منگهير
منگھيري|منگهيري
منڱڻهار|منڱڻھار
منهائڻ|منھائڻ
منهائي|منھائي
منهان|منھان
منهانڇڙو|منھانڇڙو
منهاند|منھاند
منهانڊو|منھانڊو
منهانکڙو|منھانکڙو
منهن|منھن
منهنجي|منھنجي
منهند|منھند
منهندا|منھندا
منهندار|منھندار
منهندان|منھندان
منهنداهون|منھنداھون
منهنديرو|منھنديرو
منهنڊ|منھنڊ
منهنڙو|منھنڙو
منهنڪاڻ|منھنڪاڻ
منهنگائي|منھنگائي
منهنگو|منھنگو
منهڻ|منھڻ
منهولگڙو|منھولگڙو
منهون|منھون
منهي|منھي
منهيار|منھيار
منهين|منھين
منوهار|منوھار
منوهر|منوھر
منوهڙي|منوھڙي
مڻوهر|مڻوھر
مڻيهار|مڻيھار
مڻيهاري|مڻيھاري
مها|مھا
مهائڻ|مھائڻ
مهائي|مھائي
مهائين|مھائين
مهاپاپي|مھاپاپي
مهاپرش|مھاپرش
مهاتم|مھاتم
مهاتما|مھاتما
مهاجر|مھاجر
مهاجرت|مھاجرت
مهاڄڻ|مھاڄڻ
مهاڇڙ|مھاڇڙ
مهاڇڙو|مھاڇڙو
مهاديو|مھاديو
مهاڏو|مھاڏو
مهاڏي|مھاڏي
مهار|مھار
مهاراجا|مھاراجا
مهاراڻو|مھاراڻو
مهاراڻي|مھاراڻي
مهارت|مھارت
مهارجڻ|مھارجڻ
مهارڙو|مھارڙو
مهارو|مھارو
مهارون|مھارون
مهاري|مھاري
مهاڙ|مھاڙ
مهاڙو|مھاڙو
مهاڙي|مھاڙي
مهاشيه|مھاشيہ
مهاکڙو|مھاکڙو
مهاڪ|مھاڪ
مهاڳ|مھاڳ
مهاڳو|مھاڳو
مهامري|مھامري
مهانئو|مھانئو
مهانئين|مھانئين
مهانڇرو|مھانڇرو
مهاند|مھاند
مهاندي|مھاندي
مهانڊو|مھانڊو
مهانگ|مھانگ
مهانگائي|مھانگائي
مهانگو|مھانگو
مهاڻڪو|مھاڻڪو
مهاڻو|مھاڻو
مهاوت|مھاوت
مهپارو|مھپارو
مهت|مھت
مهتاب|مھتاب
مهتابي|مھتابي
مهتدي|مھتدي
مهتر|مھتر
مهتمم|مھتمم
مهتممي|مھتممي
مهتو|مھتو
مهٽ|مھٽ
مهٽائڻ|مھٽائڻ
مهٽڻ|مھٽڻ
مهٽو|مھٽو
مهٽيل|مھٽيل
مهجر|مھجر
مهجور|مھجور
مهد|مھد
مهدي|مھدي
مهذب|مھذب
مهڍو|مھڍو
مهر|مھر
مهرا|مھرا
مهرائڻ|مھرائڻ
مهراج|مھراج
مهراڙو|مھراڙو
مهران|مھران
مهراڻ|مھراڻ
مهراڻو|مھراڻو
مهراڻي|مھراڻي
مهربان|مھربان
مهرباني|مھرباني
مهرجڻ|مھرجڻ
مهرعلي|مھرعلي
مهره|مھرہ
مهرو|مھرو
مهري|مھري
مهڙ|مھڙ
مهڙو|مھڙو
مهڪ|مھڪ
مهڪي|مھڪي
مهڳ|مھڳ
مهل|مھل
مهلائتا|مھلائتا
مهلاڻي|مھلاڻي
مهلب|مھلب
مهلت|مھلت
مهلڙ|مھلڙ
مهلڙو|مھلڙو
مهلڪ|مھلڪ
مهلو|مھلو
مهم|مھم
مهما|مھما
مهماء|مھماء
مهمائڻ|مھمائڻ
مهمان|مھمان
مهماندار|مھماندار
مهمانداري|مھمانداري
مهماني|مھماني
مهمت|مھمت
مهمل|مھمل
مهموڪ|مھموڪ
مهمون|مھمون
مهمير|مھمير
مهميرو|مھميرو
مهميز|مھميز
مهن|مھن
مهنال|مھنال
مهنت|مھنت
مهند|مھند
مهندا|مھندا
مهندائي|مھندائي
مهندار|مھندار
مهندڙي|مھندڙي
مهندس|مھندس
مهندسي|مھندسي
مهندو|مھندو
مهندوڻڪو|مھندوڻڪو
مهندوڻو|مھندوڻو
مهندي|مھندي
مهنديار|مھنديار
مهنديرو|مھنديرو
مهنديون|مھنديون
مهنگ|مھنگ
مهنگائي|مھنگائي
مهنگڙو|مھنگڙو
مهنگڙيات|مھنگڙيات
مهنگڙيو|مھنگڙيو
مهنگو|مھنگو
مهنو|مھنو
مهني|مھني
مهڻ|مھڻ
مهڻائتو|مھڻائتو
مهڻڻ|مھڻڻ
مهڻو|مھڻو
مهڻي|مھڻي
مهڻيگور|مھڻيگور
مهه|مھہ
مهو|مھو
مهوئي|مھوئي
مهوال|مھوال
مهورت|مھورت
مهوس|مھوس
مهوسي|مھوسي
مهوکي|مھوکي
مهوکيون|مھوکيون
مهوم|مھوم
مهون|مھون
مهي|مھي
مهيئاٽ|مھيئاٽ
مهيا|مھيا
مهيب|مھيب
مهيجو|مھيجو
مهير|مھير
مهيري|مھيري
مهيسر|مھيسر
مهيسري|مھيسري
مهيسي|مھيسي
مهيش|مھيش
مهيشوي|مھيشوي
مهيشي|مھيشي
مهيلي|مھيلي
مهيم|مھيم
مهين|مھين
مهينا|مھينا
مهيناري|مھيناري
مهينو|مھينو
مهيني|مھيني
مهينيدار|مھينيدار
مهيڻ|مھيڻ
مهيو|مھيو
مهيون|مھيون
مواهير|مواھير
موجواهه|موجواھ
موجوده|موجودہ
مورانجھر|مورانجهر
موراهي|موراھي
مورجھر|مورجهر
مورخه|مورخہ
مورڌنيه|مورڌنيہ
مورهڏي|مورھڏي
مورھين|مورهين
موڙھل|موڙهل
موڙھڻ|موڙهڻ
موڙھھ|موڙه
موڙھو|موڙهو
موڙھيو|موڙهيو
موگهه|موگهہ
موگھھ|موگهہ
موگھو|موگهو
مولھائو|مولهائو
مولھاٽو|مولهاٽو
مولھاٽي|مولهاٽي
مولھڙو|مولهڙو
مولھڻ|مولهڻ
مولھھ|مولهہ
مولھو|مولهو
مولھيو|مولهيو
مونجھارو|مونجهارو
مونجھاري|مونجهاري
مونجھه|مونجھہ
مونجھھ|مونجهہ
مونجھو|مونجهو
مونڊاهه|مونڊاھ
مونگھان|مونگهان
موه|موھ
موهبت|موھبت
موهت|موھت
موهتو|موھتو
موهجڻ|موھجڻ
موهجي|موھجي
موهر|موھر
موهرو|موھرو
موهڙ|موھڙ
موهل|موھل
موهلا|موھلا
موهن|موھن
موهنٿال|موھنٿال
موهنداڻي|موھنداڻي
موهنگ|موھنگ
موهنو|موھنو
موهڻ|موھڻ
موهڻو|موھڻو
موهڻي|موھڻي
موهه|موھ
موهو|موھو
موهيڙو|موھيڙو
موھھ|موھہ
ميٽاهڙ|ميٽاھڙ
ميٽهوڙي|ميٽھوڙي
ميرانجھڙو|ميرانجهڙو
ميردهو|ميردھو
ميرواهه|ميرواھ
ميڙھھ|ميڙه
ميڙھي|ميڙهي
ميسرھھ|ميسرہ
ميگھاچن|ميگهاچن
ميگھھ|ميگهہ
ميگھواڙ|ميگهواڙ
ميلڻهار|ميلڻھار
ميلھھ|ميلهہ
ميمنه|ميمنہ
مينگھڙ|مينگهڙ
مينگھلو|مينگهلو
مينگھھ|مينگهه
مينگھو|مينگهو
مينگھواڙ|مينگهواڙ
مينهانئون|مينھانئون
مينهاڻو|مينھاڻو
مينهن|مينھن
مينهڻ|مينھڻ
مينهڻو|مينھڻو
مينهوڳي|مينھوڳي
مينهون|مينھون
ميڻتهو|ميڻتھو
ميهئي|ميھئي
ميهار|ميھار
ميهارڪي|ميھارڪي
ميهاڳ|ميھاڳ
ميهاڻي|ميھاڻي
ميهر|ميھر
ميهڙو|ميھڙو
ميهڻو|ميھڻو
ميهو|ميھو
ميهوئي|ميھوئي
نااهل|نااھل
نابه|نابہ
نادره|نادرہ
نازيه|نازيہ
ناسفته|ناسفتہ
ناسمجھھ|ناسمجهہ
ناسمجھي|ناسمجهي
نافهم|نافھم
ناقه|ناقہ
ناڪاره|ناڪارہ
ناگاه|ناگاھ
ناگناهه|ناگناھ
ناگهان|ناگھان
ناگهاني|ناگھاني
ناله|نالہ
نامه|نامہ
نانجھائي|نانجهائي
نانجھو|نانجهو
نانگواه|نانگواھ
نانهن|نانھن
نانهه|نانھہ
نانھين|نانهين
ناهر|ناھر
ناهري|ناھري
ناهڙ|ناھڙ
ناهڪي|ناھڪي
ناهل|ناھل
ناهنجار|ناھنجار
ناهڻي|ناھڻي
ناهه|ناھ
ناهيا|ناھيا
ناهيد|ناھيد
ناهيو|ناھيو
ناھھ|ناھہ
نباهڻ|نباھڻ
نباهو|نباھو
نباهي|نباھي
نبهڻ|نبھڻ
نپائڻهار|نپائڻھار
نپهري|نپھري
نٽهڻ|نٽھڻ
نجاهه|نجاھ
نجھرڻ|نجهرڻ
نجھرو|نجهرو
نراهه|نراھ
نرگھٽ|نرگهٽ
نرگھول|نرگهول
نرناهه|نرناھ
نرهه|نرھ
نرواهه|نرواھ
نزهت|نزھت
نڙگھوٽ|نڙگهوٽ
نڙگھوٽو|نڙگهوٽو
نفقه|نفقہ
نقاره|نقارہ
نقاهت|نقاھت
نقره|نقرہ
نڪته|نڪتہ
نڪرهه|نڪره
نڪهت|نڪھت
نڪهه|نڪهہ
نڪهير|نڪھير
نڪهيرون|نڪھيرون
نڪهيري|نڪھيري
نگاه|نگاھ
نگاهداشت|نگاھداشت
نگاهه|نگاھ
نگاهون|نگاھون
نگه|نگھ
نگهبان|نگھبان
نگهباني|نگھباني
نگھا|نگها
نگھارڻ|نگهارڻ
نگھرو|نگهرو
نگھو|نگهو
نگھوسار|نگهوسار
نگھيرڻ|نگهيرڻ
نگھيواري|نگهيواري
نلاهين|نلاھين
نلھائي|نلهائي
ننڌاه|ننڌاھ
ننگهه|ننگهہ
ننگھوسار|ننگهوسار
ننهد|ننھد
ننهن|ننھن
ننهنڊ|ننھنڊ
ننهنڊڻ|ننھنڊڻ
ننهنور|ننھنور
ننهنوريون|ننھنوريون
ننهڻ|ننھڻ
ننهه|ننھہ
ننھائين|ننهائين
ننھٿرو|ننهٿرو
ننھو|ننهو
ننھون|ننهون
نه|نہ
نهاء|نھاء
نهائين|نھائين
نهاد|نھاد
نهار|نھار
نهارڻ|نھارڻ
نهارڻي|نھارڻي
نهارو|نھارو
نهاري|نھاري
نهاريو|نھاريو
نهال|نھال
نهالاڻي|نھالاڻي
نهالي|نھالي
نهان|نھان
نهانء|نھانء
نهاڻي|نھاڻي
نهايت|نھايت
نهٺائي|نھٺائي
نهٺو|نھٺو
نهٿيو|نھٿيو
نهر|نھر
نهرائي|نھرائي
نهراج|نھراج
نهراڻي|نھراڻي
نهرڻ|نھرڻ
نهرو|نھرو
نهري|نھري
نهريوار|نھريوار
نهريواڻ|نھريواڻ
نهڙ|نھڙ
نهڙڻ|نھڙڻ
نهڙي|نھڙي
نهڙيا|نھڙيا
نهڦل|نھڦل
نهڪار|نھڪار
نهڪر|نھڪر
نهڪلنڪ|نھڪلنڪ
نهل|نھل
نهلو|نھلو
نهن|نھن
نهنڊ|نھنڊ
نهنڊراڙ|نھنڊراڙ
نهنڊڻ|نھنڊڻ
نهنڊو|نھنڊو
نهنڊي|نھنڊي
نهنگ|نھنگ
نهڻ|نھڻ
نهه|نھہ
نهو|نھو
نهور|نھور
نهوڙ|نھوڙ
نهوڙجڻ|نھوڙجڻ
نهوڙڻ|نھوڙڻ
نهوڙي|نھوڙي
نهون|نھون
نهي|نھي
نهيا|نھيا
نهيترڻ|نھيترڻ
نهيتڻ|نھيتڻ
نهيرڻ|نھيرڻ
نهيرو|نھيرو
نهيلو|نھيلو
نهين|نھين
نھ|نہ
نواله|نوالہ
نوبهار|نوبھار
نوتيرهي|نوتيرھي
نوحه|نوحہ
نودنه|نودنہ
نورشاهه|نورشاھ
نورگھھ|نورگهہ
نوشاهي|نوشاھي
نوشهرو|نوشھرو
نوشهروفيروز|نوشھروفيروز
نوشهه|نوشھہ
نوگرهي|نوگرھي
نونهال|نونھال
نونهن|نونھن
نونهي|نونھي
نونهيو|نونھيو
نوهار|نوھار
نوهٺ|نوھٺ
نوهر|نوھر
نوهريا|نوھريا
نوهڙو|نوھڙو
نوهند|نوھند
نوهندراڙ|نوھندراڙ
نوهڻ|نوھڻ
نوهي|نوھي
نوهيرڻ|نوھيرڻ
نيباهه|نيباھ
نيباهو|نيباھو
نيباهي|نيباھي
نيبهه|نيبھہ
نيٻوجهر|نيٻوجھر
نيره|نيرھ
نيڪاهو|نيڪاھو
نيگھارڻ|نيگهارڻ
نيميچه|نيميچہ
نينٻها|نينٻھا
نينزهيو|نينزھيو
نينگھارڻو|نينگهارڻو
نينگھھ|نينگهہ
نينگھو|نينگهو
نينهائي|نينھائي
نينهان|نينھان
نينهر|نينھر
نينهڙيل|نينھڙيل
نينهن|نينھن
نينهنگ|نينھنگ
نينهون|نينھون
نيهار|نيھار
نيهاڪ|نيھاڪ
نيهان|نيھان
نيهر|نيھر
نيهرڻ|نيھرڻ
نيهرو|نيھرو
نيهڙو|نيھڙو
نيهڙي|نيھڙي
نيهن|نيھن
نيهنڊ|نيھنڊ
نيهنڊائو|نيھنڊائو
نيهنگ|نيھنگ
نيهه|نيھہ
نيهو|نيھو
نيهون|نيھون
نيهي|نيھي
نيهيرو|نيھيرو
هئائين|ھئائين
هئان|ھئان
هئبت|ھئبت
هئبتناڪ|ھئبتناڪ
هئبٿاڻي|ھئبٿاڻي
هئت|ھئت
هئدو|ھئدو
هئدوس|ھئدوس
هئدي|ھئدي
هئڊ|ھئڊ
هئڊائون|ھئڊائون
هئڊو|ھئڊو
هئڊي|ھئڊي
هئڙو|ھئڙو
هئس|ھئس
هئن|ھئن
هئنڊ|ھئنڊ
هئڻ|ھئڻ
هئڻهڙ|ھئڻھڙ
هئڻو|ھئڻو
هئڻي|ھئڻي
هئو|ھئو
هئون|ھئون
هئيتي|ھئيتي
هئين|ھئين
هاءِ|ھاءِ
هائپ|ھائپ
هائس|ھائس
هائڪو|ھائڪو
هائو|ھائو
هائوء|ھائوء
هائوس|ھائوس
هائون|ھائون
هائي|ھائي
هائينيس|ھائينيس
هاب|ھاب
هابو|ھابو
هابيل|ھابيل
هاٻڙ|ھاٻڙ
هاٻو|ھاٻو
هاٻوڙجڻ|ھاٻوڙجڻ
هاٻوڙو|ھاٻوڙو
هاپو|ھاپو
هاڀڙ|ھاڀڙ
هاتار|ھاتار
هاتر|ھاتر
هاتف|ھاتف
هاتڪ|ھاتڪ
هاٺ|ھاٺ
هاٺي|ھاٺي
هاٽيلو|ھاٽيلو
هاٿ|ھاٿ
هاٿڙ|ھاٿڙ
هاٿنگ|ھاٿنگ
هاٿني|ھاٿني
هاٿي|ھاٿي
هاٿيء|ھاٿيء
هاٿياڻي|ھاٿياڻي
هاج|ھاج
هاجاڻا|ھاجاڻا
هاجت|ھاجت
هاجتلاهڻ|ھاجتلاھڻ
هاجر|ھاجر
هاجران|ھاجران
هاجي|ھاجي
هاڃ|ھاڃ
هاڃا|ھاڃا
هاڃو|ھاڃو
هاڃي|ھاڃي
هاڄارو|ھاڄارو
هادي|ھادي
هاڍو|ھاڍو
هاڏاري|ھاڏاري
هاڏر|ھاڏر
هاڏو|ھاڏو
هاڏيرو|ھاڏيرو
هاڏيري|ھاڏيري
هاڏيو|ھاڏيو
هار|ھار
هارئو|ھارئو
هارائڻ|ھارائڻ
هارپ|ھارپ
هارپائي|ھارپائي
هارپان|ھارپان
هارپڻ|ھارپڻ
هارپو|ھارپو
هارتو|ھارتو
هارج|ھارج
هارجڻ|ھارجڻ
هارجي|ھارجي
هاردي|ھاردي
هارڪو|ھارڪو
هارڻ|ھارڻ
هارڻهورڻ|ھارڻھورڻ
هارو|ھارو
هارواڙو|ھارواڙو
هاروت|ھاروت
هارولا|ھارولا
هارون|ھارون
هاروني|ھاروني
هاروير|ھاروير
هاري|ھاري
هاريو|ھاريو
هاڙ|ھاڙ
هاڙٻ|ھاڙٻ
هاڙٻو|ھاڙٻو
هاڙٻي|ھاڙٻي
هاڙه|هاڙہ
هاڙها|ھاڙها
هاڙهه|هاڙهہ
هاڙهو|ھاڙهو
هاڙهي|ھاڙهي
هاڙهياري|ھاڙهياري
هاڙي|ھاڙي
هاسٽل|ھاسٽل
هاسڙ|ھاسڙ
هاسڪار|ھاسڪار
هاسڪاري|ھاسڪاري
هاسو|ھاسو
هاسي|ھاسي
هاسيڪار|ھاسيڪار
هاش|ھاش
هاشا|ھاشا
هاشم|ھاشم
هاشماڻي|ھاشماڻي
هاشمي|ھاشمي
هاضمو|ھاضمو
هاڪ|ھاڪ
هاڪار|ھاڪار
هاڪارڻ|ھاڪارڻ
هاڪارو|ھاڪارو
هاڪاريو|ھاڪاريو
هاڪٽ|ھاڪٽ
هاڪر|ھاڪر
هاڪڙو|ھاڪڙو
هاڪو|ھاڪو
هاگامو|ھاگامو
هاگم|ھاگم
هاڳ|ھاڳ
هاڳامو|ھاڳامو
هال|ھال
هالا|ھالا
هالاتي|ھالاتي
هالار|ھالار
هالارو|ھالارو
هالاري|ھالاري
هالان|ھالان
هالاڻو|ھالاڻو
هالاڻي|ھالاڻي
هالڪي|ھالڪي
هالو|ھالو
هالورو|ھالورو
هالي|ھالي
هاليپوٽا|ھاليپوٽا
هاليپوٽاڻي|ھاليپوٽاڻي
هاليپوٽو|ھاليپوٽو
هاليجي|ھاليجي
هاليچو|ھاليچو
هاليسو|ھاليسو
هاليو|ھاليو
هام|ھام
هامان|ھامان
هامدي|ھامدي
هان|ھان
هانئي|ھانئي
هانبارو|ھانبارو
هانبو|ھانبو
هانڀارو|ھانڀارو
هانڀي|ھانڀي
هانتي|ھانتي
هانداڻو|ھانداڻو
هانڊ|ھانڊ
هانڊاپو|ھانڊاپو
هانڊو|ھانڊو
هانڊيو|ھانڊيو
هانڍ|ھانڍ
هانڍي|ھانڍي
هانڍيا|ھانڍيا
هانڏي|ھانڏي
هانڪ|ھانڪ
هانڪڻ|ھانڪڻ
هانهر|ھانھر
هانو|ھانو
هاڻ|ھاڻ
هاڻو|ھاڻو
هاڻوڪو|ھاڻوڪو
هاڻون|ھاڻون
هاڻي|ھاڻي
هاهاڪار|ھاھاڪار
هاهر|ھاھر
هاهڙ|ھاھڙ
هاهوئاڙ|ھاھوئاڙ
هاهوت|ھاھوت
هاهيارو|ھاھيارو
هاوانو|ھاوانو
هاواڻو|ھاواڻو
هاورجڻ|ھاورجڻ
هاوڙ|ھاوڙ
هاون|ھاون
هاوي|ھاوي
هبلا|ھبلا
هبوب|ھبوب
هبيري|ھبيري
هٻاڙ|ھٻاڙ
هٻڇ|ھٻڇ
هٻڇي|ھٻڇي
هٻڙ|ھٻڙ
هٻڙاٽ|ھٻڙاٽ
هٻڙتو|ھٻڙتو
هٻڙس|ھٻڙس
هٻس|ھٻس
هٻڪ|ھٻڪ
هٻڪار|ھٻڪار
هٻڪارو|ھٻڪارو
هٻڪاري|ھٻڪاري
هٻڪڻ|ھٻڪڻ
هٻڪو|ھٻڪو
هٻلاسو|ھٻلاسو
هٻلاسي|ھٻلاسي
هٻلاکو|ھٻلاکو
هٻو|ھٻو
هٻوڇي|ھٻوڇي
هپ|ھپ
هپائجڻ|ھپائجڻ
هپائڻ|ھپائڻ
هپامڻ|ھپامڻ
هپجڻ|ھپجڻ
هپڪرڻ|ھپڪرڻ
هپڻ|ھپڻ
هپو|ھپو
هپي|ھپي
هت|ھت
هتئن|ھتئن
هتئين|ھتئين
هتار|ھتار
هتان|ھتان
هتانهون|ھتانھون
هتانهين|ھتانھين
هتب|ھتب
هتر|ھتر
هترائڻ|ھترائڻ
هترانڪي|ھترانڪي
هتڙي|ھتڙي
هتسان|ھتسان
هتڪ|ھتڪ
هتڪاري|ھتڪاري
هتنئن|ھتنئن
هتو|ھتو
هتون|ھتون
هتي|ھتي
هتيا|ھتيا
هتيار|ھتيار
هتيارو|ھتيارو
هتيپوٽو|ھتيپوٽو
هتيڇو|ھتيڇو
هٺائتو|ھٺائتو
هٺاهٺي|ھٺاھٺي
هٺر|ھٺر
هٺي|ھٺي
هٺيلائي|ھٺيلائي
هٺيلو|ھٺيلو
هٽ|ھٽ
هٽائڻ|ھٽائڻ
هٽائي|ھٽائي
هٽار|ھٽار
هٽجڻ|ھٽجڻ
هٽجي|ھٽجي
هٽر|ھٽر
هٽڙي|ھٽڙي
هٽکٽو|ھٽکٽو
هٽڪ|ھٽڪ
هٽڪائڻ|ھٽڪائڻ
هٽڪڻ|ھٽڪڻ
هٽگڻ|ھٽگڻ
هٽڻ|ھٽڻ
هٽڻو|ھٽڻو
هٽڻي|ھٽڻي
هٽو|ھٽو
هٽيلو|ھٽيلو
هٽين|ھٽين
هٿ|ھٿ
هٿئر|ھٿئر
هٿئون|ھٿئون
هٿائو|ھٿائو
هٿاڙي|ھٿاڙي
هٿان|ھٿان
هٿاوڙو|ھٿاوڙو
هٿايو|ھٿايو
هٿباڻو|ھٿباڻو
هٿرادو|ھٿرادو
هٿراڌو|ھٿراڌو
هٿرو|ھٿرو
هٿري|ھٿري
هٿڙ|ھٿڙ
هٿڙو|ھٿڙو
هٿڙي|ھٿڙي
هٿڪڙي|ھٿڪڙي
هٿلڳڻ|ھٿلڳڻ
هٿليو|ھٿليو
هٿن|ھٿن
هٿناٽ|ھٿناٽ
هٿڻ|ھٿڻ
هٿو|ھٿو
هٿوراڙي|ھٿوراڙي
هٿوڙو|ھٿوڙو
هٿوڙي|ھٿوڙي
هٿوڙيا|ھٿوڙيا
هٿون|ھٿون
هٿونگو|ھٿونگو
هٿي|ھٿي
هٿيئو|ھٿيئو
هٿيار|ھٿيار
هٿيارو|ھٿيارو
هٿياري|ھٿياري
هٿيالو|ھٿيالو
هٿيڙ|ھٿيڙ
هٿيڪائي|ھٿيڪائي
هٿيڪو|ھٿيڪو
هٿيلو|ھٿيلو
هٿيلي|ھٿيلي
هٿين|ھٿين
هٿيو|ھٿيو
هجر|ھجر
هجرت|ھجرت
هجري|ھجري
هجن|ھجن
هجڻ|ھجڻ
هجو|ھجو
هجوم|ھجوم
هجي|ھجي
هجيس|ھجيس
هڄڻ|ھڄڻ
هڄڻي|ھڄڻي
هچ|ھچ
هچا|ھچا
هچائون|ھچائون
هچارڻ|ھچارڻ
هچارو|ھچارو
هچڪ|ھچڪ
هچڪائڻ|ھچڪائڻ
هچڪڻ|ھچڪڻ
هچڪو|ھچڪو
هچڪي|ھچڪي
هچڻ|ھچڻ
هچي|ھچي
هد|ھد
هدايت|ھدايت
هدر|ھدر
هدڙي|ھدڙي
هدس|ھدس
هدف|ھدف
هدڻ|ھدڻ
هدو|ھدو
هدود|ھدود
هديه|ھديھ
هديو|ھديو
هديون|ھديون
هڊڪ|ھڊڪ
هڏ|ھڏ
هڏئون|ھڏئون
هڏا|ھڏا
هڏجڻ|ھڏجڻ
هڏر|ھڏر
هڏڙي|ھڏڙي
هڏڪ|ھڏڪ
هڏڪار|ھڏڪار
هڏڪارڻ|ھڏڪارڻ
هڏڪارو|ھڏڪارو
هڏڪڻ|ھڏڪڻ
هڏڪو|ھڏڪو
هڏڪوئي|ھڏڪوئي
هڏڪي|ھڏڪي
هڏهين|ھڏھين
هڏو|ھڏو
هڏي|ھڏي
هڏياري|ھڏياري
هڏياکو|ھڏياکو
هڏيون|ھڏيون
هر|ھر
هرائي|ھرائي
هرات|ھرات
هراس|ھراس
هراسان|ھراسان
هراست|ھراست
هرباب|ھرباب
هربند|ھربند
هرٻاري|ھرٻاري
هرٻر|ھرٻر
هرٻريو|ھرٻريو
هرٻو|ھرٻو
هرپد|ھرپد
هرڀ|ھرڀ
هرت|ھرت
هرتا|ھرتا
هرتال|ھرتال
هرتالو|ھرتالو
هرتالي|ھرتالي
هرتڙيو|ھرتڙيو
هرتمان|ھرتمان
هرتير|ھرتير
هرج|ھرج
هرجائي|ھرجائي
هرجاڻو|ھرجاڻو
هرچ|ھرچ
هرڇڻ|ھرڇڻ
هرد|ھرد
هردو|ھردو
هرديال|ھرديال
هرڏو|ھرڏو
هرڙائي|ھرڙائي
هرڙو|ھرڙو
هرس|ھرس
هرش|ھرش
هرڦر|ھرڦر
هرک|ھرک
هرکجڻ|ھرکجڻ
هرکر|ھرکر
هرکڻ|ھرکڻ
هرکيو|ھرکيو
هرڪائڻ|ھرڪائڻ
هرڪارو|ھرڪارو
هرڪاريو|ھرڪاريو
هرڪڻ|ھرڪڻ
هرگاهه|هرگاھ
هرگز|ھرگز
هرگنڊ|ھرگنڊ
هرڳڙو|ھرڳڙو
هرلو|ھرلو
هرماهه|هرماھ
هرمچ|ھرمچ
هرمرو|ھرمرو
هرمز|ھرمز
هرمڙو|ھرمڙو
هرمل|ھرمل
هرن|ھرن
هرناڙو|ھرناڙو
هرند|ھرند
هرنهن|ھرنھن
هرنو|ھرنو
هرڻ|ھرڻ
هرڻکڏيون|ھرڻکڏيون
هرڻو|ھرڻو
هرهه|هرھ
هرو|ھرو
هرواڻي|ھرواڻي
هروڀرو|ھروڀرو
هروٽو|ھروٽو
هروج|ھروج
هرورو|ھرورو
هرولو|ھرولو
هرونڊو|ھرونڊو
هري|ھري
هريائي|ھريائي
هريال|ھريال
هريالي|ھريالي
هرياڻ|ھرياڻ
هرياهه|ھرياھ
هريره|ھريرہ
هريري|ھريري
هريڙ|ھريڙ
هريڙون|ھريڙون
هرينه|ھرينھہ
هرينهه|ھرينھہ
هريهر|ھريھر
هريهڙ|ھريھڙ
هريو|ھريو
هريون|ھريون
هزائڻ|ھزائڻ
هزار|ھزار
هزارستان|ھزارستان
هزارن|ھزارن
هزارو|ھزارو
هزارون|ھزارون
هزاري|ھزاري
هزارين|ھزارين
هزرڻ|ھزرڻ
هڙ|ھڙ
هڙؤون|ھڙؤون
هڙئي|ھڙئي
هڙبگو|ھڙبگو
هڙٻ|ھڙٻ
هڙٻاٽ|ھڙٻاٽ
هڙٻاٽيون|ھڙٻاٽيون
هڙٻڙ|ھڙٻڙ
هڙٻو|ھڙٻو
هڙپ|ھڙپ
هڙپون|ھڙپون
هڙپي|ھڙپي
هڙپيل|ھڙپيل
هڙتڙيو|ھڙتڙيو
هڙتڪڙ|ھڙتڪڙ
هڙتير|ھڙتير
هڙڇ|ھڙڇ
هڙڇو|ھڙڇو
هڙڇون|ھڙڇون
هڙدو|ھڙدو
هڙدي|ھڙدي
هڙسجو|ھڙسجو
هڙڪ|ھڙڪ
هڙڪارو|ھڙڪارو
هڙڪت|ھڙڪت
هڙڪجڻ|ھڙڪجڻ
هڙڪڻ|ھڙڪڻ
هڙڪو|ھڙڪو
هڙڪي|ھڙڪي
هڙڳ|ھڙڳ
هڙهڙ|ھڙھڙ
هڙهه|ھڙہ
هڙهو|ھڙھو
هڙهي|ھڙھي
هڙون|ھڙون
هڙيئي|ھڙيئي
هڙيو|ھڙيو
هس|ھس
هست|ھست
هستابوزي|ھستابوزي
هستني|ھستني
هستي|ھستي
هسجڻ|ھسجڻ
هسجي|ھسجي
هسرو|ھسرو
هسڙ|ھسڙ
هسڪڻ|ھسڪڻ
هسڳري|ھسڳري
هسلي|ھسلي
هسڻ|ھسڻ
هسوار|ھسوار
هسواري|ھسواري
هسولا|ھسولا
هسونبڙو|ھسونبڙو
هسي|ھسي
هش|ھش
هشائڻ|ھشائڻ
هشام|ھشام
هشڪار|ھشڪار
هشڪارڻ|ھشڪارڻ
هشڪو|ھشڪو
هشناڪ|ھشناڪ
هشناڪي|ھشناڪي
هشنگ|ھشنگ
هشڻ|ھشڻ
هشورڪ|ھشورڪ
هشي|ھشي
هشيء|ھشيء
هشيار|ھشيار
هشياري|ھشياري
هضم|ھضم
هضمي|ھضمي
هفت|ھفت
هفتو|ھفتو
هفتيوار|ھفتيوار
هفوائي|ھفوائي
هفيز|ھفيز
هفيس|ھفيس
هڦ|ھڦ
هڦجڻ|ھڦجڻ
هڦڻ|ھڦڻ
هڦوسي|ھڦوسي
هڦي|ھڦي
هڦيون|ھڦيون
هڪ|ھڪ
هڪا|ھڪا
هڪائي|ھڪائي
هڪار|ھڪار
هڪالڻ|ھڪالڻ
هڪاهوء|ھڪاھوء
هڪاوڻي|ھڪاوڻي
هڪجهڙائي|ھڪجھڙائي
هڪجهڙو|ھڪجھڙو
هڪدم|ھڪدم
هڪر|ھڪر
هڪڙ|ھڪڙ
هڪڙا|ھڪڙا
هڪڙائڻ|ھڪڙائڻ
هڪڙائي|ھڪڙائي
هڪڙاڻ|ھڪڙاڻ
هڪڙجن|ھڪڙجن
هڪڙو|ھڪڙو
هڪڙي|ھڪڙي
هڪل|ھڪل
هڪلجڻ|ھڪلجڻ
هڪلڻ|ھڪلڻ
هڪم|ھڪم
هڪڻ|ھڪڻ
هڪو|ھڪو
هڪي|ھڪي
هڪيز|ھڪيز
هڪيو|ھڪيو
هڪيون|ھڪيون
هگاء|ھگاء
هگدائي|ھگدائي
هگدو|ھگدو
هڱ|ھڱ
هڱرو|ھڱرو
هڱورا|ھڱورا
هڱوراڻي|ھڱوراڻي
هڱورجا|ھڱورجا
هڱورجاڻي|ھڱورجاڻي
هڱورنو|ھڱورنو
هڱورو|ھڱورو
هڳ|ھڳ
هڳا|ھڳا
هڳاء|ھڳاء
هڳامو|ھڳامو
هل|ھل
هلا|ھلا
هلاء|ھلاء
هلائڻ|ھلائڻ
هلاچو|ھلاچو
هلاس|ھلاس
هلاک|ھلاک
هلاکي|ھلاکي
هلاڪ|ھلاڪ
هلاڪت|ھلاڪت
هلاڪي|ھلاڪي
هلال|ھلال
هلالي|ھلالي
هلان|ھلان
هلاڻو|ھلاڻو
هلاهل|ھلاھل
هلاوت|ھلاوت
هلايو|ھلايو
هلت|ھلت
هلتو|ھلتو
هلٽ|ھلٽ
هلچارو|ھلچارو
هلچل|ھلچل
هلچو|ھلچو
هلد|ھلد
هلر|ھلر
هلري|ھلري
هلڙائي|ھلڙائي
هلڙو|ھلڙو
هلڪ|ھلڪ
هلڪائي|ھلڪائي
هلڪار|ھلڪار
هلڪارو|ھلڪارو
هلڪاڻي|ھلڪاڻي
هلڪڙائي|ھلڪڙائي
هلڪڙو|ھلڪڙو
هلڪڙي|ھلڪڙي
هلڪو|ھلڪو
هلڪي|ھلڪي
هلندي|ھلندي
هلڻ|ھلڻ
هلڻي|ھلڻي
هلهل|ھلھل
هلو|ھلو
هلواڻ|ھلواڻ
هلواڻي|ھلواڻي
هلوتاڻي|ھلوتاڻي
هلوڪو|ھلوڪو
هلويون|ھلويون
هلي|ھلي
هليا|ھليا
هليلو|ھليلو
هليلي|ھليلي
هليهه|هليھہ
هليو|ھليو
هم|ھم
همئتي|ھمئتي
هما|ھما
هماء|ھماء
هماڙ|ھماڙ
همالي|ھمالي
هماليه|هماليہ
همام|ھمام
همان|ھمان
همايون|ھمايون
همت|ھمت
همتا|ھمتا
همتائڻ|ھمتائڻ
همتر|ھمتر
همتڙ|ھمتڙ
همتوان|ھمتوان
همتي|ھمتي
همٿئي|ھمٿئي
همدرد|ھمدرد
همدردي|ھمدردي
همدل|ھمدل
همدم|ھمدم
همذات|ھمذات
همڏيهي|ھمڏيھي
همراز|ھمراز
همراهه|ھمراھ
همراهو|ھمراھو
همراهي|ھمراھي
همرنگ|ھمرنگ
همزات|ھمزات
همزبان|ھمزبان
همزه|ھمزہ
همزو|ھمزو
همسري|ھمسري
همعصر|ھمعصر
همعهد|ھمعھد
همقدم|ھمقدم
همگير|ھمگير
همليگ|ھمليگ
همنام|ھمنام
همنوا|ھمنوا
همڻ|ھمڻ
همه|ھمہ
همهاڙ|ھمھاڙ
همو|ھمو
هموار|ھموار
همواره|ھموارہ
همون|ھمون
هميا|ھميا
همياڻو|ھمياڻو
همياڻي|ھمياڻي
همير|ھمير
هميراڻي|ھميراڻي
هميراهه|ھميراہ
هميشگي|ھميشگي
هميشه|هميشہ
هن|ھن
هنئاء|ھنئاء
هنئاچو|ھنئاچو
هنئار|ھنئار
هنئاري|ھنئاري
هنئن|ھنئن
هنئون|ھنئون
هنئين|ھنئين
هنائي|ھنائي
هنبائڻ|ھنبائڻ
هنباچو|ھنباچو
هنبار|ھنبار
هنباري|ھنباري
هنبڙ|ھنبڙ
هنبڙائڻ|ھنبڙائڻ
هنبس|ھنبس
هنبسڙو|ھنبسڙو
هنبو|ھنبو
هنبوڇا|ھنبوڇا
هنبوڇي|ھنبوڇي
هنبوشي|ھنبوشي
هنبي|ھنبي
هنبيڙه|ھنبيڙہ
هنڀو|ھنڀو
هنڀي|ھنڀي
هنج|ھنج
هنجار|ھنجار
هنجاري|ھنجاري
هنجتل|ھنجتل
هنجر|ھنجر
هنجرو|ھنجرو
هنجڙو|ھنجڙو
هنجو|ھنجو
هنجون|ھنجون
هنجي|ھنجي
هنچ|ھنچ
هنچڙ|ھنچڙ
هند|ھند
هندئاڻي|ھندئاڻي
هندان|ھندان
هنداڻو|ھنداڻو
هنداڻي|ھنداڻي
هندستان|ھندستان
هندستاني|ھندستاني
هندسه|هندسہ
هندڪار|ھندڪار
هندڪو|ھندڪو
هندو|ھندو
هندواڻي|ھندواڻي
هندوجا|ھندوجا
هندورن|ھندورن
هندورو|ھندورو
هندوستان|ھندوستان
هندوڪار|ھندوڪار
هندول|ھندول
هنديء|ھنديء
هنڊ|ھنڊ
هنڊائڻ|ھنڊائڻ
هنڊڙو|ھنڊڙو
هنڊڪو|ھنڊڪو
هنڊڻ|ھنڊڻ
هنڊو|ھنڊو
هنڊول|ھنڊول
هنڊوو|ھنڊوو
هنڊي|ھنڊي
هنڊياري|ھنڊياري
هنڊياڻو|ھنڊياڻو
هنڌ|ھنڌ
هنڌائتو|ھنڌائتو
هنڌڻو|ھنڌڻو
هنڌڻينهين|ھنڌڻينھين
هنڌين|ھنڌين
هنڍ|ھنڍ
هنڍائتو|ھنڍائتو
هنڍائڻ|ھنڍائڻ
هنڍاپ|ھنڍاپ
هنڍڙو|ھنڍڙو
هنڍڻو|ھنڍڻو
هنڍڻي|ھنڍڻي
هنڍي|ھنڍي
هنڏي|ھنڏي
هنر|ھنر
هنرائتو|ھنرائتو
هنرمند|ھنرمند
هنري|ھنري
هنريلو|ھنريلو
هنس|ھنس
هنسا|ھنسا
هنسلي|ھنسلي
هنسڻي|ھنسڻي
هنسو|ھنسو
هنڦڻ|ھنڦڻ
هنڦڻي|ھنڦڻي
هنگ|ھنگ
هنگار|ھنگار
هنگارڻ|ھنگارڻ
هنگام|ھنگام
هنگامه|ھنگامہ
هنگامو|ھنگامو
هنگامي|ھنگامي
هنگترڪان|ھنگترڪان
هنگلاج|ھنگلاج
هنگلو|ھنگلو
هنگلور|ھنگلور
هنگڻ|ھنگڻ
هنگڻو|ھنگڻو
هنگڻي|ھنگڻي
هنگول|ھنگول
هنگي|ھنگي
هنڱ|ھنڱ
هنڱورو|ھنڱورو
هنڱي|ھنڱي
هنهان|ھنھان
هنهم|ھنھم
هنهين|ھنھين
هنو|ھنو
هنود|ھنود
هنومان|ھنومان
هنوڻ|ھنوڻ
هني|ھني
هنيا|ھنيا
هنياء|ھنياء
هنيار|ھنيار
هنيارو|ھنيارو
هنياري|ھنياري
هنيان|ھنيان
هنيڙو|ھنيڙو
هنيل|ھنيل
هنيون|ھنيون
هنيين|ھنيين
هڻ|ھڻ
هڻائڻ|ھڻائڻ
هڻان|ھڻان
هڻپچار|ھڻپچار
هڻڀ|ھڻڀ
هڻڀو|ھڻڀو
هڻڀي|ھڻڀي
هڻڀيڻي|ھڻڀيڻي
هڻتڻ|ھڻتڻ
هڻڪ|ھڻڪ
هڻڪار|ھڻڪار
هڻڪارڻ|ھڻڪارڻ
هڻڪڻ|ھڻڪڻ
هڻنب|ھڻنب
هڻند|ھڻند
هڻندو|ھڻندو
هڻندي|ھڻندي
هڻڻ|ھڻڻ
هڻي|ھڻي
هه|ھ
هها|ھھا
ههڙو|ھھڙو
ههو|ھھو
ههي|ھھي
هو|ھو
هوء|ھوء
هوئڙ|ھوئڙ
هوئي|ھوئي
هوئيڙ|ھوئيڙ
هوا|ھوا
هوائون|ھوائون
هوائي|ھوائي
هواباز|ھواباز
هوادار|ھوادار
هوار|ھوار
هواڙ|ھواڙ
هوانو|ھوانو
هواڻو|ھواڻو
هوت|ھوت
هوتاس|ھوتاس
هوتاڻي|ھوتاڻي
هوتر|ھوتر
هوتڪاڻي|ھوتڪاڻي
هوتڪي|ھوتڪي
هوتمان|ھوتمان
هوتن|ھوتن
هوتو|ھوتو
هوتواڻي|ھوتواڻي
هوتواهه|ھوتواہ
هوتير|ھوتير
هوٺ|ھوٺ
هوٺي|ھوٺي
هوٿرائي|ھوٿرائي
هوٿرو|ھوٿرو
هوٿي|ھوٿي
هوٿياڻو|ھوٿياڻو
هوٿيپوٽا|ھوٿيپوٽا
هوٿير|ھوٿير
هوڄ|ھوڄ
هوچرو|ھوچرو
هوچڪائڻ|ھوچڪائڻ
هوچڪڻ|ھوچڪڻ
هوڇانڊو|ھوڇانڊو
هوڇڻ|ھوڇڻ
هود|ھود
هودارڻ|ھودارڻ
هودو|ھودو
هودي|ھودي
هوڏ|ھوڏ
هوڏاء|ھوڏاء
هوڏائتو|ھوڏائتو
هوڏائي|ھوڏائي
هوڏانهن|ھوڏانھن
هوڏانهون|ھوڏانھون
هوڏڙو|ھوڏڙو
هوڏنهن|ھوڏنھن
هوڏڻ|ھوڏڻ
هوڏو|ھوڏو
هوڏي|ھوڏي
هور|ھور
هورا|ھورا
هورائي|ھورائي
هورائيو|ھورائيو
هورڙو|ھورڙو
هورڻ|ھورڻ
هورو|ھورو
هوري|ھوري
هوريان|ھوريان
هوڙ|ھوڙ
هوڙائي|ھوڙائي
هوڙاڪ|ھوڙاڪ
هوڙام|ھوڙام
هوڙپ|ھوڙپ
هوڙڻ|ھوڙڻ
هوڙو|ھوڙو
هوڙي|ھوڙي
هوڙيگو|ھوڙيگو
هوس|ھوس
هوسڙي|ھوسڙي
هوسڻ|ھوسڻ
هوسي|ھوسي
هوسين|ھوسين
هوش|ھوش
هوشائتو|ھوشائتو
هوشاچڻ|ھوشاچڻ
هوشمند|ھوشمند
هوشمندي|ھوشمندي
هوشناڪ|ھوشناڪ
هوشناڪي|ھوشناڪي
هوشور|ھوشور
هوشي|ھوشي
هوشيار|ھوشيار
هوشياري|ھوشياري
هوڪ|ھوڪ
هوڪائي|ھوڪائي
هوڪاراهين|ھوڪاراھين
هوڪارن|ھوڪارن
هوڪارڻ|ھوڪارڻ
هوڪارو|ھوڪارو
هوڪاري|ھوڪاري
هوڪرو|ھوڪرو
هوڪو|ھوڪو
هوگيا|ھوگيا
هول|ھول
هولر|ھولر
هولڙو|ھولڙو
هولناڪ|ھولناڪ
هولو|ھولو
هولي|ھولي
هوليء|ھوليء
هوليرو|ھوليرو
هوليڙو|ھوليڙو
هومڪي|ھومڪي
هومڻ|ھومڻ
هونڇڻ|ھونڇڻ
هوند|ھوند
هوندئا|ھوندئا
هوندر|ھوندر
هوندو|ھوندو
هوندي|ھوندي
هونديء|ھونديء
هونس|ھونس
هونسجڻ|ھونسجڻ
هونسجي|ھونسجي
هونسرو|ھونسرو
هونڪڻ|ھونڪڻ
هونگ|ھونگ
هونگا|ھونگا
هونگار|ھونگار
هونگارڻ|ھونگارڻ
هونگارو|ھونگارو
هونگاري|ھونگاري
هونگر|ھونگر
هونگران|ھونگران
هونگرون|ھونگرون
هونگڙي|ھونگڙي
هونگڙيون|ھونگڙيون
هونگون|ھونگون
هونهئين|ھونھئين
هونهين|ھونھين
هوهه|هوھ
هوونهار|ھوونھار
هويدا|ھويدا
هي|ھي
هيئت|ھيئت
هيئتدان|ھيئتدان
هيئو|ھيئو
هيئي|ھيئي
هيا|ھيا
هيار|ھيار
هيالو|ھيالو
هيانء|ھيانء
هيانؤ|ھيانؤ
هيانئت|ھيانئت
هيانئتو|ھيانئتو
هيانچو|ھيانچو
هياڻ|ھياڻ
هيبت|ھيبت
هيبتناڪ|ھيبتناڪ
هيبتي|ھيبتي
هيٻئرو|ھيٻئرو
هيٻرائڻ|ھيٻرائڻ
هيٻرائي|ھيٻرائي
هيٻڙ|ھيٻڙ
هيٻڙتو|ھيٻڙتو
هيٻو|ھيٻو
هيت|ھيت
هيترو|ھيترو
هيتو|ھيتو
هيتي|ھيتي
هيٺ|ھيٺ
هيٺئون|ھيٺئون
هيٺائون|ھيٺائون
هيٺائين|ھيٺائين
هيٺار|ھيٺار
هيٺان|ھيٺان
هيٺانهون|ھيٺانھون
هيٺاهين|ھيٺاھين
هيٺتانهون|ھيٺتانھون
هيٺو|ھيٺو
هيٺون|ھيٺون
هيٺوڻو|ھيٺوڻو
هيٺين|ھيٺين
هيٺيون|ھيٺيون
هيج|ھيج
هيجا|ھيجا
هيجار|ھيجار
هيجاڙ|ھيجاڙ
هيجان|ھيجان
هيجوئار|ھيجوئار
هيجون|ھيجون
هيڄ|ھيڄ
هيدياڻي|ھيدياڻي
هيڊ|ھيڊ
هيڊائون|ھيڊائون
هيڊاڻ|ھيڊاڻ
هيڊڙي|ھيڊڙي
هيڊو|ھيڊو
هيڊي|ھيڊي
هيڏ|ھيڏ
هيڏانهن|ھيڏانھن
هيڏانهون|ھيڏانھون
هيڏانهين|ھيڏانھين
هيڏتانهون|ھيڏتانھون
هيڏڙو|ھيڏڙو
هيڏنهه|ھيڏنھہ
هيڏو|ھيڏو
هيڏي|ھيڏي
هير|ھير
هيرآباد|ھيرآباد
هيرئون|ھيرئون
هيرا|ھيرا
هيرائتو|ھيرائتو
هيرائڻ|ھيرائڻ
هيرار|ھيرار
هيراڪ|ھيراڪ
هيراڪڙ|ھيراڪڙ
هيراڪس|ھيراڪس
هيراڪڻي|ھيراڪڻي
هيران|ھيران
هيرٿو|ھيرٿو
هيرڙو|ھيرڙو
هيرڦير|ھيرڦير
هيرڪ|ھيرڪ
هيرڪو|ھيرڪو
هيرڻ|ھيرڻ
هيرڻي|ھيرڻي
هيرو|ھيرو
هيروڪي|ھيروڪي
هيرون|ھيرون
هيري|ھيري
هيريو|ھيريو
هيڙ|ھيڙ
هيڙاهو|ھيڙاھو
هيڙهه|ھيڙہ
هيڙهيان|ھيڙھيان
هيڙو|ھيڙو
هيڙي|ھيڙي
هيسائڻ|ھيسائڻ
هيسباڻي|ھيسباڻي
هيسجڻ|ھيسجڻ
هيسين|ھيسين
هيضه|ھيضہ
هيکل|ھيکل
هيکلو|ھيکلو
هيڪ|ھيڪ
هيڪا|ھيڪا
هيڪائي|ھيڪائي
هيڪار|ھيڪار
هيڪاري|ھيڪاري
هيڪان|ھيڪان
هيڪاند|ھيڪاند
هيڪاندو|ھيڪاندو
هيڪاڻي|ھيڪاڻي
هيڪاهه|ھيڪاھ
هيڪر|ھيڪر
هيڪڙ|ھيڪڙ
هيڪڙائي|ھيڪڙائي
هيڪڙائيء|ھيڪڙائيء
هيڪڙانڊ|ھيڪڙانڊ
هيڪڙو|ھيڪڙو
هيڪل|ھيڪل
هيڪلائي|ھيڪلائي
هيڪلاڻ|ھيڪلاڻ
هيڪلاڻون|ھيڪلاڻون
هيڪلو|ھيڪلو
هيڪلي|ھيڪلي
هيڪمنائي|ھيڪمنائي
هيڪمنو|ھيڪمنو
هيڪو|ھيڪو
هيڪوٽو|ھيڪوٽو
هيڪولائي|ھيڪولائي
هيڪونڊو|ھيڪونڊو
هيڪوڻ|ھيڪوڻ
هيڪوڻائي|ھيڪوڻائي
هيڪوڻو|ھيڪوڻو
هيل|ھيل
هيلاڻو|ھيلاڻو
هيلايا|ھيلايا
هيلمند|ھيلمند
هيلو|ھيلو
هيلوڪو|ھيلوڪو
هيم|ھيم
هيمار|ھيمار
هيمان|ھيمان
هيماڻي|ھيماڻي
هيمدان|ھيمدان
هيمن|ھيمن
هيمڻ|ھيمڻ
هينئان|ھينئان
هينئر|ھينئر
هينئرڪو|ھينئرڪو
هينئڙو|ھينئڙو
هينئن|ھينئن
هينئون|ھينئون
هينئين|ھينئين
هينڏ|ھينڏ
هينڏو|ھينڏو
هينس|ھينس
هينسڻ|ھينسڻ
هينگ|ھينگ
هينگڻ|ھينگڻ
هينگون|ھينگون
هينڻاري|ھينڻاري
هيڻ|ھيڻ
هيڻا|ھيڻا
هيڻائي|ھيڻائي
هيڻو|ھيڻو
هيڻي|ھيڻي
هيهات|ھيھات
هيو|ھيو
هيور|ھيور
هيوليٰ|ھيوليٰ
هيون|ھيون
هييار|ھييار
ھئجھاڻي|ھئجهاڻي
ھرمنجھھ|ھرمنجهہ
ھرنگھڻ|ھرنگهڻ
ھرنگھھ|ھرنگهہ
ھميشھ|ھميشه
ھنجھئون|ھنجهئون
ھنجھاٽي|ھنجهاٽي
ھنجھر|ھنجهر
ھنجھري|ھنجهري
ھنجھھ|ھنجهہ
ھنجھو|ھنجهو
ھنجھون|ھنجهون
ھنجھي|ھنجهي
ھوڏھن|ھوڏهن
ھوڏھون|ھوڏهون
ھوڙھائي|ھوڙهائي
ھوڙھڻ|ھوڙهڻ
ھوڙھھ|ھوڙہ
ھوڙھيائي|ھوڙهيائي
ھيڏھن|ھيڏهن
ھيڏھون|ھيڏهون
ھيڏھين|ھيڏهين
ھيڙھو|ھيڙهو
ھيلھھ|ھيلهہ
وابسته|وابستہ
واٽاهو|واٽاھو
واٽهڙ|واٽھڙ
واٽواهو|واٽواھو
واٽوهڙ|واٽوھڙ
واجه|واجہ
واجھاء|واجهاء
واجھائڻ|واجهائڻ
واجھاڻيس|واجهاڻيس
واجھڻ|واجهڻ
واجھھ|واجھہ
واڇڙھ|واڇڙه
وارنهن|وارنھن
وارهه|وارھ
واروجھڻ|واروجهڻ
واستفاده|واستفادہ
واقعه|واقعہ
واگھا|واگها
واگھڊ|واگهڊ
واگھريجي|واگهريجي
واگھريو|واگهريو
واگھڙ|واگهڙ
واگھڙجي|واگهڙجي
واگھھ|واگهہ
واگھو|واگهو
واگھوء|واگهوء
واگھوڙي|واگهوڙي
واگھيرا|واگهيرا
واگھيون|واگهيون
واڳهه|واڳھہ
والده|والدہ
والڙھيا|والڙهيا
والنهار|والنھار
والھاٽو|والهاٽو
والھوٽا|والهوٽا
واليشاهه|واليشاھ
وانجھئيل|وانجهئيل
وانجھار|وانجهار
وانجھڻ|وانجهڻ
وانجھھ|وانجهہ
وانجھو|وانجهو
وانجھي|وانجهي
وانجھيو|وانجهيو
وانگھائي|وانگهائي
وانهگو|وانھگو
وانهن|وانھن
وانهڻ|وانھڻ
وانهه|وانھہ
وانهون|وانھون
وانهوندو|وانھوندو
واڻاهه|واڻاھ
واه|واھ
واهارو|واھارو
واهب|واھب
واهپ|واھپ
واهپو|واھپو
واهپي|واھپي
واهت|واھت
واهتي|واھتي
واهٽي|واھٽي
واهر|واھر
واهرو|واھرو
واهڙ|واھڙ
واهگرو|واھگرو
واهل|واھل
واهلو|واھلو
واهمه|واھمہ
واهمي|واھمي
واهن|واھن
واهندو|واھندو
واهڻ|واھڻ
واهڻائي|واھڻائي
واهڻي|واھڻي
واهڻياري|واھڻياري
واهه|واھ
واهو|واھو
واهوچو|واھوچو
واهوڪ|واھوڪ
واهولو|واھولو
واهولي|واھولي
واهون|واھون
واهوندا|واھوندا
واهوندو|واھوندو
واهونگا|واھونگا
واهي|واھي
واهيات|واھيات
واهياتي|واھياتي
واهيارو|واھيارو
واهيپو|واھيپو
واهيت|واھيت
واهيتو|واھيتو
واهير|واھير
واهيرو|واھيرو
واهيري|واھيري
واهيو|واھيو
واوڙاهه|واوڙاھ
وبيگانه|وبيگانہ
وتاڳنه|وتاڳنھہ
وته|وتہ
وٽهڙ|وٽھڙ
وٽوهڙ|وٽوھڙ
وجاهت|وجاھت
وجه|وجھہ
وجھائتو|وجهائتو
وجھائڻ|وجهائڻ
وجھرائڻ|وجهرائڻ
وجھڙو|وجهڙو
وجھڪڻ|وجهڪڻ
وجھل|وجهل
وجھلڻ|وجهلڻ
وجھڻ|وجهڻ
وِجَھڻُ|وِجَهڻُ
وجھڻو|وجهڻو
وجھڻي|وجهڻي
وِجھه|وِجھہ
وجھھ|وجهہ
وجھو|وجهو
وجھي|وجهي
وجوهات|وجوھات
وجيه|وجيھہ
وچانهون|وچانھون
وچاهون|وچاھون
وحده|وحدہ
وڊهو|وڊھو
وڍهه|وڍه
وڏهرا|وڏھرا
وڏهريون|وڏھريون
وڏهل|وڏھل
وڏهنس|وڏھنس
وڏوهڙيو|وڏوھڙيو
وڏوهه|وڏوھ
وڏوهي|وڏوھي
ورانگھھ|ورانگهہ
وراهڻ|وراھڻ
ورجھائڻ|ورجهائڻ
ورلهڻ|ورلھڻ
ورنهن|ورنھن
ورنهه|ورنھہ
وِرهيه|وِرهيہ
ورھائجي|ورهائجي
ورھائڻ|ورهائڻ
ورھاست|ورهاست
ورھاڱو|ورهاڱو
ورھھ|وره
ورھو|ورهو
ورھيا|ورهيا
ورھيارو|ورهيارو
ورھيھ|ورهيہ
ورھيو|ورهيو
ورھيوڪو|ورهيوڪو
ورونهن|ورونھن
ورونهڻ|ورونهڻ
ورونهه|ورونھہ
وروهڙيو|وروھڙيو
وروهڻ|وروھڻ
وروهه|وروهہ
ورياهه|ورياھ
وريشه|وريشہ
ورينگھڻ|ورينگهڻ
وڙاهه|وڙاھ
وڙھل|وڙهل
وڙھڻ|وڙهڻ
وڙھي|وڙهي
وڙھيون|وڙهيون
وسنهم|وسنھم
وسهر|وسھر
وسهڻ|وسھڻ
وسهو|وسھو
وسهيان|وسھيان
وسهيس|وسھيس
وسوڙهائي|وسوڙھائي
وسينهن|وسينھن
وسينهه|وسينھہ
وسيهر|وسيھر
وصفيه|وصفيہ
وعده|وعدہ
وغيره|وغيرہ
وڪرها|وڪرھا
وگھار|وگهار
وگھارڻ|وگهارڻ
وگھامل|وگهامل
وگھرڻ|وگهرڻ
وگھرو|وگهرو
وگھڙ|وگهڙ
وگھھ|وگهہ
وگھو|وگهو
وگھور|وگهور
وگھوڙ|وگهوڙ
وگھي|وگهي
وگھيا|وگهيا
وگھيڙ|وگهيڙ
وڳه|وڳہ
وڳهه|وڳھہ
ولراه|ولراھ
ولهه|ولهہ
ولھا|ولها
ولھائي|ولهائي
ولھار|ولهار
ولھاري|ولهاري
ولھاڳرو|ولهاڳرو
ولھاڳو|ولهاڳو
ولھامڻ|ولهامڻ
ولھر|ولهر
ولھن|ولهن
ولھه|ولھہ
ولھھ|ولهہ
ولھو|ولهو
ولھوٽ|ولهوٽ
ولھوٽو|ولهوٽو
ولھور|ولهور
ولھي|ولهي
ولھيٽ|ولهيٽ
وليمه|وليمہ
ومافيها|ومافيھا
وناهپو|وناھپو
وناهجڻ|وناھجڻ
وناهڻ|وناھڻ
وناهه|وناھھ
وناهي|وناھي
وناهيو|وناھيو
ونجھار|ونجهار
ونجھر|ونجهر
ونجھل|ونجهل
ونجھلي|ونجهلي
ونجھڻ|ونجهڻ
ونجھڻي|ونجهڻي
ونجھھ|ونجهہ
ونجھو|ونجهو
ونجھوٽي|ونجهوٽي
ونجھورت|ونجهورت
ونجھي|ونجهي
ونهار|ونھار
ونهڙو|ونھڙو
ونهلو|ونھلو
ونهن|ونھن
ونهه|ونھہ
ونهيائي|ونھيائي
ونهيو|ونھيو
ونواهه|ونواھ
وڻاهجڻ|وڻاھجڻ
وڻاهه|وڻاھ
وڻاهي|وڻاھي
وڻراهه|وڻراھ
وه|وھ
وهائڻ|وھائڻ
وهائو|وھائو
وهائي|وھائي
وهائيء|وھائيء
وهاب|وھاب
وهاٽجڻ|وھاٽجڻ
وهاٽڻ|وھاٽڻ
وهاٽو|وھاٽو
وهاٽي|وھاٽي
وهار|وھار
وهارڻ|وھارڻ
وهارو|وھارو
وهاڳ|وھاڳ
وهامڻ|وھامڻ
وهان|وھان
وهانء|وھانء
وهانئتو|وھانئتو
وهانتو|وھانتو
وهانڊ|وھانڊ
وهانو|وھانو
وهاڻو|وھاڻو
وهاڻي|وھاڻي
وهاڻيون|وھاڻيون
وهتو|وھتو
وهٽ|وھٽ
وهٽڙي|وھٽڙي
وهٽڻ|وھٽڻ
وهٽي|وھٽي
وهڃائڻ|وھڃائڻ
وهڃاڻو|وھڃاڻو
وهداني|وھداني
وهر|وھر
وهرا|وھرا
وهراج|وھراج
وهراڙو|وھراڙو
وهراڙيون|وھراڙيون
وهرٿيڻ|وھرٿيڻ
وهرجڻ|وھرجڻ
وهرڻ|وھرڻ
وهرو|وھرو
وهريل|وھريل
وهڙو|وھڙو
وهڙيا|وھڙيا
وهسڻ|وھسڻ
وهڪ|وھڪ
وهڪجڻ|وھڪجڻ
وهڪرو|وھڪرو
وهڪڻ|وھڪڻ
وهڪوڙ|وھڪوڙ
وهلجڻ|وھلجڻ
وهلڻ|وھلڻ
وهلو|وھلو
وهلور|وھلور
وهلير|وھلير
وهم|وھم
وهمي|وھمي
وهنت|وھنت
وهنتل|وھنتل
وهنتو|وھنتو
وهنجارڻ|وھنجارڻ
وهنجارڻي|وھنجارڻي
وهنجڻ|وھنجڻ
وهنچڻ|وھنچڻ
وهند|وھند
وهندڙ|وھندڙ
وهندڙو|وھندڙو
وهندو|وھندو
وهندون|وھندون
وهندي|وھندي
وهنڊارڻ|وھنڊارڻ
وهنوار|وھنوار
وهنوارڪو|وھنوارڪو
وهنواري|وھنواري
وهنواريو|وھنواريو
وهنوانڌ|وھنوانڌ
وهڻ|وھڻ
وهڻائي|وھڻائي
وهڻي|وھڻي
وهه|وھ
وهو|وھو
وهواند|وھواند
وهوت|وھوت
وهوڙڻ|وھوڙڻ
وهوڳو|وھوڳو
وهول|وھول
وهي|وھي
وهياترو|وھياترو
وهيل|وھيل
وهيلي|وھيلي
وهين|وھين
وهيڻو|وھيڻو
وهيڻون|وھيڻون
وهيو|وھيو
وھھ|وھہ
ووجھو|ووجهو
ووهه|ووھ
ويانهن|ويانھن
ويجھا|ويجها
ويجھائي|ويجهائي
ويجھڙ|ويجهڙ
ويجھڻ|ويجهڻ
ويجھھ|ويجهہ
ويجھو|ويجهو
ويجھي|ويجهي
ويجھيار|ويجهيار
ويچوها|ويچوھا
ويچوهو|ويچوھو
ويڇاهڙ|ويڇاھڙ
ويڇهڙ|ويڇھڙ
ويڇهڙو|ويڇھڙو
ويڌوهڻ|ويڌوھڻ
ويراهب|ويراھب
ويراهه|ويراھ
ويڙھائڻ|ويڙهائڻ
ويڙھائو|ويڙهائو
ويڙھاٽ|ويڙهاٽ
ويڙھاٽو|ويڙهاٽو
ويڙھار|ويڙهار
ويڙھاڪ|ويڙهاڪ
ويڙھاڪو|ويڙهاڪو
ويڙھاند|ويڙهاند
ويڙھجي|ويڙهجي
ويڙھڻ|ويڙهڻ
ويڙھھ|ويڙه
ويڙھو|ويڙهو
ويڙھوٽي|ويڙهوٽي
ويڙھوگھٽو|ويڙهوگهٽو
ويڙھي|ويڙهي
ويڙھيچو|ويڙهيچو
ويڙھيل|ويڙهيل
ويسانهون|ويسانھون
ويساها|ويساھا
ويساهڻ|ويساھڻ
ويساهه|ويساھ
ويساهو|ويساھو
ويساهي|ويساھي
ويساهين|ويساھين
ويساھھ|ويساھہ
ويسهه|ويسھہ
ويسهو|ويسھو
ويسوها|ويسوھا
ويسوهو|ويسوھو
ويلھائي|ويلهائي
ويلھھ|ويلهہ
ويلھو|ويلهو
وينجھار|وينجهار
وينجھاڻو|وينجهاڻو
وينجھر|وينجهر
وينجھڪو|وينجهڪو
وينجھل|وينجهل
وينجھڻ|وينجهڻ
وينجھڻي|وينجهڻي
وينجھھ|وينجهه
وينجھول|وينجهول
وينگھو|وينگهو
ويها|ويھا
ويهائڻ|ويھائڻ
ويهارڻ|ويھارڻ
ويهارو|ويھارو
ويهٽ|ويھٽ
ويهٽڻ|ويھٽڻ
ويهجي|ويھجي
ويهڙ|ويھڙ
ويهڪ|ويھڪ
ويهڪڻ|ويھڪڻ
ويهڪي|ويھڪي
ويهلو|ويھلو
ويهن|ويھن
ويهڻ|ويھڻ
ويهڻو|ويھڻو
ويهڻي|ويھڻي
ويهه|ويھہ
ويهو|ويھو
ويهون|ويھون
ويهونورڻ|ويھونورڻ
ويهي|ويھي
ويهين|ويھين
يابنده|يابندہ
يارانڪهن|يارانڪھن
يارھن|يارهن
يارھو|يارهو
يارھون|يارهون
يارھوڻ|يارهوڻ
يارھوڻو|يارهوڻو
يارھين|يارهين
يازده|يازدہ
يافته|يافتہ
يانهن|يانھن
ياهه|ياھ
ياهو|ياھو
ياوه|ياوھ
يايخواهي|يايخواھي
يجھائـڻ|يجهائـڻ
يگانه|يگانہ
يهنگير|يھنگير
يهود|يھود
يهودا|يھودا
يهوداڻو|يھوداڻو
يهودي|يھودي
يوجهه|يوجهہ
